AAAAAACTTTT -> AAAAACTTTTA
AAAAACTTTTA -> AAAACTTTTAA
AAAAATACTGT -> AAAATACTGTG
AAAAATCAACC -> AAAATCAACCG
AAAAATTCTTC -> AAAATTCTTCC
AAAACAGCAAG -> AAACAGCAAGC
AAAACGACGCT -> AAACGACGCTT
AAAACTTTTAA -> AAACTTTTAAT
AAAAGGACTTC -> AAAGGACTTCG
AAAAGTGGATG -> AAAGTGGATGA
AAAATACTGTG -> AAATACTGTGG
AAAATCAACCG -> AAATCAACCGT
AAAATTCTTCC -> AAATTCTTCCC
AAACAGCAAGC -> AACAGCAAGCT
AAACATTTGTA -> AACATTTGTAA
AAACCAAGCAT -> AACCAAGCATT
AAACCAGCGAG -> AACCAGCGAGG
AAACGACGCTT -> AACGACGCTTG
AAACGCAATCA -> AACGCAATCAA
AAACGTAGCTT -> AACGTAGCTTG
AAACTTACGAC -> AACTTACGACT
AAACTTTTAAT -> AACTTTTAATC
AAAGCTCCCGA -> AAGCTCCCGAA
AAAGGACTTCG -> AAGGACTTCGA
AAAGTCCCGAC -> AAGTCCCGACC
AAAGTGGATGA -> AAGTGGATGAC
AAATACTGTGG -> AATACTGTGGG
AAATCAACCGT -> AATCAACCGTG
AAATCACGAGC -> AATCACGAGCA
AAATGAGATTG -> AATGAGATTGT
AAATGCATTTC -> AATGCATTTCT
AAATTCTTCCC -> AATTCTTCCCT
AAATTTAACCT -> AATTTAACCTC
AAATTTGAATA -> AATTTGAATAG
AACAAACCAGC -> ACAAACCAGCG
AACAATCTATC -> ACAATCTATCG
AACACAACGAT -> ACACAACGATG
AACACCATCCA -> ACACCATCCAC
AACAGCAAGCT -> ACAGCAAGCTC
AACATTTGTAA -> ACATTTGTAAC
AACCAAGCATT -> ACCAAGCATTC
AACCAGCGAGG -> ACCAGCGAGGC
AACCGCAGATT -> ACCGCAGATTT
AACCGCCACCT -> ACCGCCACCTA
AACCGTGCAAC -> ACCGTGCAACC
AACCTCCAGAT -> ACCTCCAGATG
AACCTCCCTAG -> ACCTCCCTAGT
AACCTCGATAT -> ACCTCGATATT
AACGACGCTTG -> ACGACGCTTGT
AACGATGACAG -> ACGATGACAGC
AACGCAATCAA -> ACGCAATCAAG
AACGGACGAGT -> ACGGACGAGTG
AACGGAGTGCA -> ACGGAGTGCAG
AACGTAGCTTG -> ACGTAGCTTGG
AACGTAGTTGT -> ACGTAGTTGTA
AACGTGGCCGT -> ACGTGGCCGTT
AACTATGTCGA -> ACTATGTCGAC
AACTCGGAAAA -> ACTCGGAAAAA
AACTCTTTTTA -> ACTCTTTTTAG
AACTTACGACT -> ACTTACGACTT
AACTTCAAGCA -> ACTTCAAGCAG
AACTTCAATGG -> ACTTCAATGGA
AACTTGGTCTT -> ACTTGGTCTTG
AACTTTTAATC -> ACTTTTAATCT
AAGAAGGCGTA -> AGAAGGCGTAC
AAGACTTTTTG -> AGACTTTTTGG
AAGAGTATTTT -> AGAGTATTTTA
AAGCAGAATCC -> AGCAGAATCCG
AAGCATAACTT -> AGCATAACTTC
AAGCATTCCTC -> AGCATTCCTCC
AAGCGGAGTGA -> AGCGGAGTGAG
AAGCTCCCGAA -> AGCTCCCGAAA
AAGCTCGATGG -> AGCTCGATGGC
AAGGACTTCGA -> AGGACTTCGAT
AAGGCGCGTTG -> AGGCGCGTTGC
AAGGCGTACAT -> AGGCGTACATA
AAGGTCCTGGC -> AGGTCCTGGCC
AAGTAGCATCA -> AGTAGCATCAT
AAGTAGGGTGG -> AGTAGGGTGGA
AAGTCAGTGGT -> AGTCAGTGGTA
AAGTCCCGACC -> AGTCCCGACCG
AAGTGCTTAAC -> AGTGCTTAACC
AAGTGGATGAC -> AGTGGATGACA
AAGTGGCACTA -> AGTGGCACTAG
AAGTGTCATGA -> AGTGTCATGAG
AAGTGTGGAGC -> AGTGTGGAGCG
AAGTTAGGCCG -> AGTTAGGCCGG
AATACATTTAG -> ATACATTTAGG
AATACTGAAAC -> ATACTGAAACG
AATACTGTGGG -> ATACTGTGGGC
AATAGAGCGTT -> ATAGAGCGTTC
AATCAACCGTG -> ATCAACCGTGC
AATCAAGTAGG -> ATCAAGTAGGG
AATCACGAGCA -> ATCACGAGCAC
AATCCGACAAA -> ATCCGACAAAG
AATCGAGCAAC -> ATCGAGCAACA
AATCGTTATTT -> ATCGTTATTTT
AATCTAGACTC -> ATCTAGACTCA
AATCTATCGAA -> ATCTATCGAAC
AATCTTATAAC -> ATCTTATAACT
AATCTTCCCCG -> ATCTTCCCCGA
AATGAGATTGT -> ATGAGATTGTG
AATGATAGAGA -> ATGATAGAGAT
AATGCATTTCT -> ATGCATTTCTG
AATGCCATTCT -> ATGCCATTCTT
AATGGAGGTGG -> ATGGAGGTGGT
AATGGTTTCGT -> ATGGTTTCGTA
AATGTCGACAT -> ATGTCGACATT
AATTAATGGTT -> ATTAATGGTTT
AATTACTAAGT -> ATTACTAAGTG
AATTCAAGGTC -> ATTCAAGGTCC
AATTCTTCCCT -> ATTCTTCCCTA
AATTTAACCTC -> ATTTAACCTCG
AATTTGAATAG -> ATTTGAATAGA
ACAAAAGGACT -> CAAAAGGACTT
ACAAACCAGCG -> CAAACCAGCGA
ACAAAGTCCCG -> CAAAGTCCCGA
ACAACGATGAC -> CAACGATGACA
ACAACGGACGA -> CAACGGACGAG
ACAACGGAGTG -> CAACGGAGTGC
ACAATCTATCG -> CAATCTATCGA
ACACAACGATG -> CACAACGATGA
ACACATCGCTA -> CACATCGCTAT
ACACCATCCAC -> CACCATCCACT
ACACTAGAGTG -> CACTAGAGTGC
ACACTTCCCCT -> CACTTCCCCTG
ACAGCAAGCTC -> CAGCAAGCTCG
ACAGCACAACG -> CAGCACAACGG
ACAGCACGTGT -> CAGCACGTGTG
ACAGGGGGGGG -> CAGGGGGGGGC
ACATATATTAG -> CATATATTAGT
ACATATTTCTC -> CATATTTCTCT
ACATCACAAAA -> CATCACAAAAG
ACATCGAAAAC -> CATCGAAAACG
ACATCGCTATG -> CATCGCTATGC
ACATGGGACCA -> CATGGGACCAT
ACATTAGAAAA -> CATTAGAAAAA
ACATTTAGGAG -> CATTTAGGAGC
ACATTTGTAAC -> CATTTGTAACT
ACATTTGTGCA -> CATTTGTGCAT
ACATTTTCACC -> CATTTTCACCA
ACCAAAAAACT -> CCAAAAAACTT
ACCAAACATTT -> CCAAACATTTG
ACCAAGCATTC -> CCAAGCATTCC
ACCACACTTCC -> CCACACTTCCC
ACCAGAACACC -> CCAGAACACCA
ACCAGACCGTC -> CCAGACCGTCC
ACCAGCGACGA -> CCAGCGACGAT
ACCAGCGAGGC -> CCAGCGAGGCT
ACCATCCACTT -> CCATCCACTTA
ACCATGGGACC -> CCATGGGACCT
ACCCCATCGAT -> CCCCATCGATC
ACCCGAGGCAA -> CCCGAGGCAAA
ACCCGATGGGA -> CCCGATGGGAC
ACCGACGCGGA -> CCGACGCGGAT
ACCGCAGATTT -> CCGCAGATTTT
ACCGCCACCTA -> CCGCCACCTAT
ACCGTCCACGA -> CCGTCCACGAT
ACCGTGCAACC -> CCGTGCAACCG
ACCGTTTCTTC -> CCGTTTCTTCC
ACCTAATTACT -> CCTAATTACTA
ACCTATAAAAG -> CCTATAAAAGT
ACCTCCAGATG -> CCTCCAGATGT
ACCTCCAGGTA -> CCTCCAGGTAT
ACCTCCCTAGT -> CCTCCCTAGTG
ACCTCGATATT -> CCTCGATATTA
ACCTGTATAAT -> CCTGTATAATA
ACCTTATGTAC -> CCTTATGTACA
ACGAAGGCGCG -> CGAAGGCGCGT
ACGACCTCCAG -> CGACCTCCAGG
ACGACGCAAGA -> CGACGCAAGAA
ACGACGCTTGT -> CGACGCTTGTG
ACGACTTGGCG -> CGACTTGGCGC
ACGAGCACATT -> CGAGCACATTT
ACGAGTGGTCC -> CGAGTGGTCCG
ACGATATTCAT -> CGATATTCATC
ACGATCGAGTA -> CGATCGAGTAC
ACGATGACAGC -> CGATGACAGCA
ACGATGAGTAG -> CGATGAGTAGA
ACGCAAGAAGG -> CGCAAGAAGGC
ACGCAATCAAG -> CGCAATCAAGT
ACGCGGATGAG -> CGCGGATGAGC
ACGCTTGTGTT -> CGCTTGTGTTT
ACGGACGACGC -> CGGACGACGCA
ACGGACGAGTG -> CGGACGAGTGG
ACGGAGGAGTA -> CGGAGGAGTAC
ACGGAGTGCAG -> CGGAGTGCAGC
ACGTAGCTTGG -> CGTAGCTTGGA
ACGTAGTTGTA -> CGTAGTTGTAT
ACGTCTTATAC -> CGTCTTATACG
ACGTGACGTCT -> CGTGACGTCTT
ACGTGGCCGTT -> CGTGGCCGTTT
ACGTGTGTCCC -> CGTGTGTCCCT
ACTAAGTGGCA -> CTAAGTGGCAC
ACTACCCGATG -> CTACCCGATGG
ACTAGAACTCG -> CTAGAACTCGG
ACTAGAGTGCA -> CTAGAGTGCAA
ACTATGTCGAC -> CTATGTCGACA
ACTCAATCTTC -> CTCAATCTTCC
ACTCCCGCGTG -> CTCCCGCGTGA
ACTCCGTCAGC -> CTCCGTCAGCC
ACTCGGAAAAA -> CTCGGAAAAAT
ACTCTTTTTAG -> CTCTTTTTAGT
ACTGAAACGTA -> CTGAAACGTAG
ACTGCTTGATT -> CTGCTTGATTT
ACTGGAGGCAT -> CTGGAGGCATT
ACTGTGGGCCC -> CTGTGGGCCCG
ACTTACGACTT -> CTTACGACTTG
ACTTAGGAAGC -> CTTAGGAAGCA
ACTTCAAGCAG -> CTTCAAGCAGA
ACTTCAATGGA -> CTTCAATGGAG
ACTTCCAAATG -> CTTCCAAATGC
ACTTCCCCTGG -> CTTCCCCTGGA
ACTTCGATAAG -> CTTCGATAAGT
ACTTCTGAGCG -> CTTCTGAGCGT
ACTTGGCGCTT -> CTTGGCGCTTC
ACTTGGTCTTG -> CTTGGTCTTGG
ACTTTTAATCT -> CTTTTAATCTA
ACTTTTTGGTA -> CTTTTTGGTAG
AGAAAAATACT -> GAAAAATACTG
AGAAACGCAAT -> GAAACGCAATC
AGAACACCATC -> GAACACCATCC
AGAACTCGGAA -> GAACTCGGAAA
AGAAGCGGAGT -> GAAGCGGAGTG
AGAAGGCGTAC -> GAAGGCGTACA
AGAATCCGACA -> GAATCCGACAA
AGACCCCATCG -> GACCCCATCGA
AGACCGTCCAC -> GACCGTCCACG
AGACCTGTATA -> GACCTGTATAA
AGACTCAATCT -> GACTCAATCTT
AGACTCCCGCG -> GACTCCCGCGT
AGACTTCTGAG -> GACTTCTGAGC
AGACTTTTTGG -> GACTTTTTGGT
AGAGATTGTCG -> GAGATTGTCGC
AGAGCGTTCTC -> GAGCGTTCTCT
AGAGTATTTTA -> GAGTATTTTAA
AGAGTGCAATG -> GAGTGCAATGA
AGATACCACAC -> GATACCACACT
AGATGTCGTAG -> GATGTCGTAGG
AGATTCATGCT -> GATTCATGCTT
AGATTGTCGCA -> GATTGTCGCAT
AGATTGTGTGT -> GATTGTGTGTC
AGATTTTACAT -> GATTTTACATA
AGCAACAATCT -> GCAACAATCTA
AGCAACACAAC -> GCAACACAACG
AGCAAGCTCGA -> GCAAGCTCGAT
AGCACAACGGA -> GCACAACGGAG
AGCACATTTTC -> GCACATTTTCA
AGCACGTGTGT -> GCACGTGTGTC
AGCAGAATCCG -> GCAGAATCCGA
AGCATAACTTC -> GCATAACTTCA
AGCATAATGCC -> GCATAATGCCA
AGCATCATTGA -> GCATCATTGAT
AGCATTCCTCC -> GCATTCCTCCG
AGCCATAGATA -> GCCATAGATAC
AGCCATTCGGG -> GCCATTCGGGA
AGCCCACGGAC -> GCCCACGGACG
AGCCCTCGTAG -> GCCCTCGTAGT
AGCCTCGTGAG -> GCCTCGTGAGT
AGCCTGTATAC -> GCCTGTATACC
AGCGACAGGGG -> GCGACAGGGGG
AGCGACGATGA -> GCGACGATGAG
AGCGAGGCTTT -> GCGAGGCTTTC
AGCGCGAGACT -> GCGCGAGACTT
AGCGGAGTGAG -> GCGGAGTGAGT
AGCGTGCCATG -> GCGTGCCATGT
AGCGTGTATAT -> GCGTGTATATA
AGCGTTCTCTG -> GCGTTCTCTGA
AGCTAGGGGAA -> GCTAGGGGAAC
AGCTCCCGAAA -> GCTCCCGAAAT
AGCTCGATGGC -> GCTCGATGGCA
AGCTTGGAGCC -> GCTTGGAGCCC
AGGAAGCATAA -> GGAAGCATAAC
AGGACTTCGAT -> GGACTTCGATA
AGGAGCATAAT -> GGAGCATAATG
AGGAGTACATG -> GGAGTACATGG
AGGATATGGGA -> GGATATGGGAG
AGGCAAAAATC -> GGCAAAAATCA
AGGCATTGCCT -> GGCATTGCCTC
AGGCCGGTGTA -> GGCCGGTGTAA
AGGCCTCCATA -> GGCCTCCATAA
AGGCGAGCCCA -> GGCGAGCCCAC
AGGCGCGTTGC -> GGCGCGTTGCT
AGGCGTACATA -> GGCGTACATAT
AGGCTTTCAAG -> GGCTTTCAAGA
AGGGGAACAAA -> GGGGAACAAAC
AGGGGGGGGCG -> GGGGGGGGCGC
AGGGTGACTGG -> GGGTGACTGGA
AGGGTGGACAT -> GGGTGGACATC
AGGTATCATAA -> GGTATCATAAC
AGGTCCTGGCC -> GGTCCTGGCCG
AGGTGGTAACT -> GGTGGTAACTT
AGGTTCCTGCC -> GGTTCCTGCCA
AGGTTTGAGCT -> GGTTTGAGCTA
AGTACATGGGA -> GTACATGGGAC
AGTACCCGAGG -> GTACCCGAGGC
AGTACGTGACG -> GTACGTGACGT
AGTAGAAGCGG -> GTAGAAGCGGA
AGTAGCATCAT -> GTAGCATCATT
AGTAGGGTGGA -> GTAGGGTGGAC
AGTAGTGCTGG -> GTAGTGCTGGG
AGTATTTTAAA -> GTATTTTAAAA
AGTATTTTTCA -> GTATTTTTCAA
AGTCAGTGGTA -> GTCAGTGGTAG
AGTCCCGACCG -> GTCCCGACCGA
AGTCCGAGATT -> GTCCGAGATTC
AGTCCTTGAAT -> GTCCTTGAATC
AGTCTTAATCT -> GTCTTAATCTT
AGTGAGTCCTT -> GTGAGTCCTTG
AGTGCAATGAT -> GTGCAATGATA
AGTGCAGCCTG -> GTGCAGCCTGT
AGTGCGGCTAT -> GTGCGGCTATC
AGTGCTGGGTC -> GTGCTGGGTCG
AGTGCTTAACC -> GTGCTTAACCG
AGTGGAGACCT -> GTGGAGACCTG
AGTGGAGTGGT -> GTGGAGTGGTG
AGTGGATGACA -> GTGGATGACAC
AGTGGCACCAG -> GTGGCACCAGA
AGTGGCACTAG -> GTGGCACTAGA
AGTGGTAGCCA -> GTGGTAGCCAT
AGTGGTCCGAG -> GTGGTCCGAGG
AGTGGTGGGTA -> GTGGTGGGTAA
AGTGTCATGAG -> GTGTCATGAGG
AGTGTGGAGCG -> GTGTGGAGCGA
AGTTAAACCAA -> GTTAAACCAAG
AGTTACTTCCA -> GTTACTTCCAA
AGTTAGGCCGG -> GTTAGGCCGGT
AGTTCCAATAC -> GTTCCAATACA
AGTTGTATCTG -> GTTGTATCTGA
ATAAAAGTGGA -> TAAAAGTGGAT
ATAACGTAGTT -> TAACGTAGTTG
ATAACTTCAAT -> TAACTTCAATG
ATAAGTCAGTG -> TAAGTCAGTGG
ATAAGTGCTTA -> TAAGTGCTTAA
ATAATACTGAA -> TAATACTGAAA
ATAATGCCATT -> TAATGCCATTC
ATACATTTAGG -> TACATTTAGGA
ATACCAAACAT -> TACCAAACATT
ATACCACACTT -> TACCACACTTC
ATACCAGCGAC -> TACCAGCGACG
ATACGGAGGAG -> TACGGAGGAGT
ATACTGAAACG -> TACTGAAACGT
ATACTGTGGGC -> TACTGTGGGCC
ATAGAGATTGT -> TAGAGATTGTC
ATAGAGCGTTC -> TAGAGCGTTCT
ATAGATACCAC -> TAGATACCACA
ATAGTCTTAAT -> TAGTCTTAATC
ATATAGTCTTA -> TATAGTCTTAA
ATATATTAGTC -> TATATTAGTCC
ATATGGGAGTA -> TATGGGAGTAC
ATATTAATTAA -> TATTAATTAAT
ATATTAGTCCG -> TATTAGTCCGA
ATATTCATCAA -> TATTCATCAAA
ATATTTCTCTA -> TATTTCTCTAA
ATCAAATGAGA -> TCAAATGAGAT
ATCAACCGTGC -> TCAACCGTGCA
ATCAAGTAGGG -> TCAAGTAGGGT
ATCACAAAAGG -> TCACAAAAGGA
ATCACGAGCAC -> TCACGAGCACA
ATCAGTATTTT -> TCAGTATTTTT
ATCATAACGTA -> TCATAACGTAG
ATCATGCCAGA -> TCATGCCAGAA
ATCATTGATAC -> TCATTGATACC
ATCCACTTAGG -> TCCACTTAGGA
ATCCGACAAAG -> TCCGACAAAGT
ATCCGGTGTGC -> TCCGGTGTGCG
ATCGAAAACGA -> TCGAAAACGAC
ATCGAACTCTT -> TCGAACTCTTT
ATCGAGCAACA -> TCGAGCAACAA
ATCGAGGCGAG -> TCGAGGCGAGC
ATCGAGTACCC -> TCGAGTACCCG
ATCGATCGCCG -> TCGATCGCCGC
ATCGCCGCGAA -> TCGCCGCGAAA
ATCGCTATGCA -> TCGCTATGCAA
ATCGTTATTTT -> TCGTTATTTTT
ATCTAGACTCA -> TCTAGACTCAA
ATCTATCGAAC -> TCTATCGAACT
ATCTGAGGATA -> TCTGAGGATAT
ATCTGCTTGCG -> TCTGCTTGCGG
ATCTTATAACT -> TCTTATAACTA
ATCTTCCCCGA -> TCTTCCCCGAG
ATGACACTAGA -> TGACACTAGAG
ATGACAGCACA -> TGACAGCACAA
ATGAGATTGTG -> TGAGATTGTGT
ATGAGCGTGTA -> TGAGCGTGTAT
ATGAGGTTTGA -> TGAGGTTTGAG
ATGAGTAGAAG -> TGAGTAGAAGC
ATGAGTTCCAA -> TGAGTTCCAAT
ATGATAGAGAT -> TGATAGAGATT
ATGCAACCTCC -> TGCAACCTCCC
ATGCATTTCTG -> TGCATTTCTGG
ATGCCAGAAAC -> TGCCAGAAACG
ATGCCATTCTT -> TGCCATTCTTG
ATGCTTGGAAT -> TGCTTGGAATT
ATGGAGGTGGT -> TGGAGGTGGTA
ATGGCACATCG -> TGGCACATCGA
ATGGGACCATG -> TGGGACCATGG
ATGGGACCTAA -> TGGGACCTAAT
ATGGGACCTTA -> TGGGACCTTAT
ATGGGAGTACG -> TGGGAGTACGT
ATGGTTTCGTA -> TGGTTTCGTAT
ATGTACAGCAC -> TGTACAGCACG
ATGTCGACATT -> TGTCGACATTA,TGTCGACATTT
ATGTCGTAGGT -> TGTCGTAGGTT
ATGTCTTACTC -> TGTCTTACTCC
ATTAATGGTTT -> TTAATGGTTTC
ATTAATTAATG -> TTAATTAATGG
ATTACTAAGTG -> TTACTAAGTGG
ATTAGAAAAAT -> TTAGAAAAATA
ATTAGTCCGAG -> TTAGTCCGAGA
ATTCAAGGTCC -> TTCAAGGTCCT
ATTCATCAAAT -> TTCATCAAATG
ATTCATGCTTG -> TTCATGCTTGG
ATTCCTCCGTA -> TTCCTCCGTAA
ATTCGACGACC -> TTCGACGACCT
ATTCGGGAATG -> TTCGGGAATGT
ATTCTTCCCTA -> TTCTTCCCTAC
ATTCTTGTTGC -> TTCTTGTTGCC
ATTGATACCAG -> TTGATACCAGC
ATTGCCTCTAT -> TTGCCTCTATG
ATTGTCGCATT -> TTGTCGCATTC
ATTGTGTGTCG -> TTGTGTGTCGT
ATTGTTCTTCA -> TTGTTCTTCAG
ATTTAACCTCG -> TTTAACCTCGA
ATTTAGGAGCA -> TTTAGGAGCAT
ATTTATCAGTA -> TTTATCAGTAT
ATTTCTCTAAT -> TTTCTCTAATC
ATTTCTGGCAA -> TTTCTGGCAAC
ATTTGAATAGA -> TTTGAATAGAG
ATTTGTAACTA -> TTTGTAACTAT
ATTTGTGCATT -> TTTGTGCATTG
ATTTTAAAACA -> TTTTAAAACAG
ATTTTACATAT -> TTTTACATATA
ATTTTCACCAG -> TTTTCACCAGA
ATTTTTCAAGT -> TTTTTCAAGTT
ATTTTTGTACT -> TTTTTGTACTA
CAAAAAACTTT -> AAAAAACTTTT
CAAAAATCAAC -> AAAAATCAACC
CAAAAGGACTT -> AAAAGGACTTC
CAAACATTTGT -> AAACATTTGTA
CAAACCAGCGA -> AAACCAGCGAG
CAAACTTACGA -> AAACTTACGAC
CAAAGCTCCCG -> AAAGCTCCCGA
CAAAGTCCCGA -> AAAGTCCCGAC
CAAATGAGATT -> AAATGAGATTG
CAAATGCATTT -> AAATGCATTTC
CAACAATCTAT -> AACAATCTATC
CAACACAACGA -> AACACAACGAT
CAACCGCAGAT -> AACCGCAGATT
CAACCGTGCAA -> AACCGTGCAAC
CAACCTCCCTA -> AACCTCCCTAG
CAACGATGACA -> AACGATGACAG
CAACGGACGAG -> AACGGACGAGT
CAACGGAGTGC -> AACGGAGTGCA
CAACTTGGTCT -> AACTTGGTCTT
CAAGAAGGCGT -> AAGAAGGCGTA
CAAGACTTTTT -> AAGACTTTTTG
CAAGCAGAATC -> AAGCAGAATCC
CAAGCATTCCT -> AAGCATTCCTC
CAAGCTCGATG -> AAGCTCGATGG
CAAGGTCCTGG -> AAGGTCCTGGC
CAAGTAGGGTG -> AAGTAGGGTGG
CAAGTGTCATG -> AAGTGTCATGA
CAAGTTAGGCC -> AAGTTAGGCCG
CAATACATTTA -> AATACATTTAG
CAATCAAGTAG -> AATCAAGTAGG
CAATCTATCGA -> AATCTATCGAA
CAATCTTCCCC -> AATCTTCCCCG
CAATGATAGAG -> AATGATAGAGA
CAATGGAGGTG -> AATGGAGGTGG
CACAAAAGGAC -> ACAAAAGGACT
CACAACGATGA -> ACAACGATGAC
CACAACGGACG -> ACAACGGACGA
CACAACGGAGT -> ACAACGGAGTG
CACACTTCCCC -> ACACTTCCCCT
CACATCGAAAA -> ACATCGAAAAC
CACATCGCTAT -> ACATCGCTATG
CACATTTTCAC -> ACATTTTCACC
CACCAGAACAC -> ACCAGAACACC
CACCAGACCGT -> ACCAGACCGTC
CACCATCCACT -> ACCATCCACTT
CACCTATAAAA -> ACCTATAAAAG
CACGAGCACAT -> ACGAGCACATT
CACGATATTCA -> ACGATATTCAT
CACGGACGACG -> ACGGACGACGC
CACGTGTGTCC -> ACGTGTGTCCC
CACTAGAACTC -> ACTAGAACTCG
CACTAGAGTGC -> ACTAGAGTGCA
CACTTAGGAAG -> ACTTAGGAAGC
CACTTCCCCTG -> ACTTCCCCTGG
CAGAAACGCAA -> AGAAACGCAAT
CAGAACACCAT -> AGAACACCATC
CAGAATCCGAC -> AGAATCCGACA
CAGACCCCATC -> AGACCCCATCG
CAGACCGTCCA -> AGACCGTCCAC
CAGATGTCGTA -> AGATGTCGTAG
CAGATTTTACA -> AGATTTTACAT
CAGCAAGCTCG -> AGCAAGCTCGA
CAGCACAACGG -> AGCACAACGGA
CAGCACGTGTG -> AGCACGTGTGT
CAGCCATTCGG -> AGCCATTCGGG
CAGCCTCGTGA -> AGCCTCGTGAG
CAGCCTGTATA -> AGCCTGTATAC
CAGCGACGATG -> AGCGACGATGA
CAGCGAGGCTT -> AGCGAGGCTTT
CAGGGGGGGGC -> AGGGGGGGGCG
CAGGGTGACTG -> AGGGTGACTGG
CAGGTATCATA -> AGGTATCATAA
CAGTATTTTTC -> AGTATTTTTCA
CAGTGGAGACC -> AGTGGAGACCT
CAGTGGTAGCC -> AGTGGTAGCCA
CATAACGTAGT -> ATAACGTAGTT
CATAACTTCAA -> ATAACTTCAAT
CATAAGTGCTT -> ATAAGTGCTTA
CATAATGCCAT -> ATAATGCCATT
CATAGATACCA -> ATAGATACCAC
CATATATTAGT -> ATATATTAGTC
CATATTTCTCT -> ATATTTCTCTA
CATCAAATGAG -> ATCAAATGAGA
CATCACAAAAG -> ATCACAAAAGG
CATCATTGATA -> ATCATTGATAC
CATCCACTTAG -> ATCCACTTAGG
CATCCGGTGTG -> ATCCGGTGTGC
CATCGAAAACG -> ATCGAAAACGA
CATCGATCGCC -> ATCGATCGCCG
CATCGCTATGC -> ATCGCTATGCA
CATGAGGTTTG -> ATGAGGTTTGA
CATGCCAGAAA -> ATGCCAGAAAC
CATGCTTGGAA -> ATGCTTGGAAT
CATGGGACCAT -> ATGGGACCATG
CATGGGACCTT -> ATGGGACCTTA
CATGTCTTACT -> ATGTCTTACTC
CATTAGAAAAA -> ATTAGAAAAAT
CATTCCTCCGT -> ATTCCTCCGTA
CATTCGACGAC -> ATTCGACGACC
CATTCGGGAAT -> ATTCGGGAATG
CATTCTTGTTG -> ATTCTTGTTGC
CATTGATACCA -> ATTGATACCAG
CATTGCCTCTA -> ATTGCCTCTAT
CATTGTTCTTC -> ATTGTTCTTCA
CATTTAGGAGC -> ATTTAGGAGCA
CATTTCTGGCA -> ATTTCTGGCAA
CATTTGTAACT -> ATTTGTAACTA
CATTTGTGCAT -> ATTTGTGCATT
CATTTTCACCA -> ATTTTCACCAG
CCAAAAAACTT -> CAAAAAACTTT
CCAAACATTTG -> CAAACATTTGT
CCAAAGCTCCC -> CAAAGCTCCCG
CCAAATGCATT -> CAAATGCATTT
CCAAGCATTCC -> CAAGCATTCCT
CCAAGTGTCAT -> CAAGTGTCATG
CCAATACATTT -> CAATACATTTA
CCACACTTCCC -> CACACTTCCCC
CCACCTATAAA -> CACCTATAAAA
CCACGATATTC -> CACGATATTCA
CCACGGACGAC -> CACGGACGACG
CCACTTAGGAA -> CACTTAGGAAG
CCAGAAACGCA -> CAGAAACGCAA
CCAGAACACCA -> CAGAACACCAT
CCAGACCGTCC -> CAGACCGTCCA
CCAGATGTCGT -> CAGATGTCGTA
CCAGCCTCGTG -> CAGCCTCGTGA
CCAGCGACGAT -> CAGCGACGATG
CCAGCGAGGCT -> CAGCGAGGCTT
CCAGGGTGACT -> CAGGGTGACTG
CCAGGTATCAT -> CAGGTATCATA
CCATAAGTGCT -> CATAAGTGCTT
CCATAGATACC -> CATAGATACCA
CCATCCACTTA -> CATCCACTTAG
CCATCCGGTGT -> CATCCGGTGTG
CCATCGATCGC -> CATCGATCGCC
CCATGGGACCT -> CATGGGACCTT
CCATGTCTTAC -> CATGTCTTACT
CCATTCGGGAA -> CATTCGGGAAT
CCATTCTTGTT -> CATTCTTGTTG
CCCACGGACGA -> CCACGGACGAC
CCCATCGATCG -> CCATCGATCGC
CCCCATCGATC -> CCCATCGATCG
CCCCGAGCAAC -> CCCGAGCAACA
CCCCTGGACTG -> CCCTGGACTGC
CCCGAAATTTG -> CCGAAATTTGA
CCCGACCGACG -> CCGACCGACGC
CCCGAGCAACA -> CCGAGCAACAC
CCCGAGGCAAA -> CCGAGGCAAAA
CCCGATGGGAC -> CCGATGGGACC
CCCGCGGGGTA -> CCGCGGGGTAA
CCCGCGTGAGT -> CCGCGTGAGTT
CCCTACCAAAA -> CCTACCAAAAA
CCCTAGTGCGG -> CCTAGTGCGGC
CCCTCGTAGTG -> CCTCGTAGTGG
CCCTGGACTGC -> CCTGGACTGCT
CCCTGTTACGA -> CCTGTTACGAA
CCGAAATTTGA -> CGAAATTTGAA
CCGACAAAGTC -> CGACAAAGTCC
CCGACCGACGC -> CGACCGACGCG
CCGACGCGGAT -> CGACGCGGATG
CCGAGATTCAT -> CGAGATTCATG
CCGAGCAACAC -> CGAGCAACACA
CCGAGGCAAAA -> CGAGGCAAAAA
CCGAGGCCTCC -> CGAGGCCTCCA
CCGATGGGACC -> CGATGGGACCT
CCGCAGATTTT -> CGCAGATTTTA
CCGCCACCTAT -> CGCCACCTATA
CCGCGAAATCA -> CGCGAAATCAC
CCGCGGGGTAA -> CGCGGGGTAAC
CCGCGTGAGTT -> CGCGTGAGTTA
CCGGACGATCG -> CGGACGATCGA
CCGGCGGGCTC -> CGGCGGGCTCA
CCGGGAACCTC -> CGGGAACCTCC
CCGGTGTAAGT -> CGGTGTAAGTA
CCGGTGTGCGA -> CGGTGTGCGAT
CCGTAAATTTA -> CGTAAATTTAA
CCGTCAGCCAT -> CGTCAGCCATT
CCGTCCACGAT -> CGTCCACGATA
CCGTGCAACCG -> CGTGCAACCGC
CCGTTGAAGTG -> CGTTGAAGTGT
CCGTTTCCATC -> CGTTTCCATCC
CCGTTTCTTCC -> CGTTTCTTCCA
CCTAATTACTA -> CTAATTACTAA
CCTACCAAAAA -> CTACCAAAAAA
CCTAGTGCGGC -> CTAGTGCGGCT
CCTATAAAAGT -> CTATAAAAGTG
CCTCCAGATGT -> CTCCAGATGTC
CCTCCAGGTAT -> CTCCAGGTATC
CCTCCATAAGT -> CTCCATAAGTG
CCTCCCTAGTG -> CTCCCTAGTGC
CCTCCGTAAAT -> CTCCGTAAATT
CCTCGATATTA -> CTCGATATTAA
CCTCGTAGTGG -> CTCGTAGTGGA
CCTCGTGAGTT -> CTCGTGAGTTA
CCTCTATGAGT -> CTCTATGAGTT
CCTGCCAGCCT -> CTGCCAGCCTC
CCTGGACTGCT -> CTGGACTGCTT
CCTGGCCGGCG -> CTGGCCGGCGG
CCTGTATAATA -> CTGTATAATAC
CCTGTATACCA -> CTGTATACCAA
CCTGTTACGAA -> CTGTTACGAAG
CCTTATGTACA -> CTTATGTACAG
CCTTGAATCGT -> CTTGAATCGTT
CGAAAACGACG -> GAAAACGACGC
CGAAATCACGA -> GAAATCACGAG
CGAAATTTGAA -> GAAATTTGAAT
CGAACTCTTTT -> GAACTCTTTTT
CGAAGGCGCGT -> GAAGGCGCGTT
CGACAAAGTCC -> GACAAAGTCCC
CGACAGGGGGG -> GACAGGGGGGG
CGACATTAGAA -> GACATTAGAAA
CGACATTTGTG -> GACATTTGTGC
CGACCGACGCG -> GACCGACGCGG
CGACCGTTTCT -> GACCGTTTCTT
CGACCTCCAGG -> GACCTCCAGGT
CGACGACCTCC -> GACGACCTCCA
CGACGATGAGT -> GACGATGAGTA
CGACGCAAGAA -> GACGCAAGAAG
CGACGCGGATG -> GACGCGGATGA
CGACGCTTGTG -> GACGCTTGTGT
CGACTTGGCGC -> GACTTGGCGCT
CGAGACTCCCG -> GAGACTCCCGC
CGAGACTTCTG -> GAGACTTCTGA
CGAGATTCATG -> GAGATTCATGC
CGAGCAACAAT -> GAGCAACAATC
CGAGCAACACA -> GAGCAACACAA
CGAGCACATTT -> GAGCACATTTT
CGAGCCCACGG -> GAGCCCACGGA
CGAGGCAAAAA -> GAGGCAAAAAT
CGAGGCCTCCA -> GAGGCCTCCAT
CGAGGCGAGCC -> GAGGCGAGCCC
CGAGGCTTTCA -> GAGGCTTTCAA
CGAGTACCCGA -> GAGTACCCGAG
CGAGTGGTCCG -> GAGTGGTCCGA
CGATAAGTCAG -> GATAAGTCAGT
CGATATTAATT -> GATATTAATTA
CGATATTCATC -> GATATTCATCA
CGATCGAGTAC -> GATCGAGTACC
CGATCGCCGCG -> GATCGCCGCGA
CGATCTGCTTG -> GATCTGCTTGC
CGATGACAGCA -> GATGACAGCAC
CGATGAGTAGA -> GATGAGTAGAA
CGATGGCACAT -> GATGGCACATC
CGATGGGACCT -> GATGGGACCTA
CGCAAGAAGGC -> GCAAGAAGGCG
CGCAATCAAGT -> GCAATCAAGTA
CGCAGATTTTA -> GCAGATTTTAC
CGCATTCGACG -> GCATTCGACGA
CGCCACCTATA -> GCCACCTATAA
CGCCGCGAAAT -> GCCGCGAAATC
CGCGAAATCAC -> GCGAAATCACG
CGCGAGACTTC -> GCGAGACTTCT
CGCGGATGAGC -> GCGGATGAGCG
CGCGGGGTAAC -> GCGGGGTAACG
CGCGGTCGAGA -> GCGGTCGAGAC
CGCGTGAGTTA -> GCGTGAGTTAC
CGCGTTGCTTG -> GCGTTGCTTGC
CGCGTTTGGCC -> GCGTTTGGCCG
CGCTATGCAAC -> GCTATGCAACC
CGCTTCCGGGA -> GCTTCCGGGAA
CGCTTGTGTTT -> GCTTGTGTTTG
CGGAAAAATTC -> GGAAAAATTCT
CGGACGACGCA -> GGACGACGCAA
CGGACGAGTGG -> GGACGAGTGGT
CGGACGATCGA -> GGACGATCGAG
CGGAGGAGTAC -> GGAGGAGTACA
CGGAGTGAGTC -> GGAGTGAGTCC
CGGAGTGCAGC -> GGAGTGCAGCC
CGGATGAGCGT -> GGATGAGCGTG
CGGCGGGCTCA -> GGCGGGCTCAG
CGGCGTGGTCC -> GGCGTGGTCCA
CGGCTATCGAG -> GGCTATCGAGG
CGGGAACCTCC -> GGGAACCTCCA
CGGGAATGTCG -> GGGAATGTCGA
CGGGCTCAGAC -> GGGCTCAGACC
CGGGGTAACGT -> GGGGTAACGTG
CGGTCGAGACT -> GGTCGAGACTC
CGGTGTAAGTA -> GGTGTAAGTAG
CGGTGTGCGAT -> GGTGTGCGATC
CGTAAATTTAA -> GTAAATTTAAC
CGTACATATTT -> GTACATATTTC
CGTAGCTTGGA -> GTAGCTTGGAG
CGTAGGTTCCT -> GTAGGTTCCTG
CGTAGTGGAGT -> GTAGTGGAGTG
CGTAGTTGTAT -> GTAGTTGTATC
CGTATCATGCC -> GTATCATGCCA
CGTCAGCCATT -> GTCAGCCATTC
CGTCCACGATA -> GTCCACGATAT
CGTCGACCGTT -> GTCGACCGTTT
CGTCTTATACG -> GTCTTATACGG
CGTGACGTCTT -> GTGACGTCTTA
CGTGAGTTAAA -> GTGAGTTAAAC
CGTGAGTTACT -> GTGAGTTACTT
CGTGCAACCGC -> GTGCAACCGCA
CGTGCCATGTC -> GTGCCATGTCT
CGTGGCCGTTT -> GTGGCCGTTTC
CGTGGTCCAAG -> GTGGTCCAAGT
CGTGTATATAG -> GTGTATATAGT
CGTGTGTCCCT -> GTGTGTCCCTG
CGTTATTTTTG -> GTTATTTTTGT
CGTTCTCTGAC -> GTTCTCTGACA
CGTTGAAGTGT -> GTTGAAGTGTG
CGTTGCTTGCC -> GTTGCTTGCCA
CGTTTCCATCC -> GTTTCCATCCG
CGTTTCTTCCA -> GTTTCTTCCAG
CGTTTGGCCGT -> GTTTGGCCGTT
CTAAGTGGCAC -> TAAGTGGCACT
CTAATCGAGCA -> TAATCGAGCAA
CTAATTACTAA -> TAATTACTAAG
CTACCAAAAAA -> TACCAAAAAAC
CTACCCGATGG -> TACCCGATGGG
CTAGAACTCGG -> TAGAACTCGGA
CTAGACTCAAT -> TAGACTCAATC
CTAGAGTGCAA -> TAGAGTGCAAT
CTAGGGGAACA -> TAGGGGAACAA
CTAGTGCGGCT -> TAGTGCGGCTA
CTATAAAAGTG -> TATAAAAGTGG
CTATCGAACTC -> TATCGAACTCT
CTATCGAGGCG -> TATCGAGGCGA
CTATGAGTTCC -> TATGAGTTCCA
CTATGCAACCT -> TATGCAACCTC
CTATGTCGACA -> TATGTCGACAT
CTCAATCTTCC -> TCAATCTTCCC
CTCAGACCCCA -> TCAGACCCCAT
CTCCAGATGTC -> TCCAGATGTCG
CTCCAGGTATC -> TCCAGGTATCA
CTCCATAAGTG -> TCCATAAGTGC
CTCCCGAAATT -> TCCCGAAATTT
CTCCCGCGTGA -> TCCCGCGTGAG
CTCCCTAGTGC -> TCCCTAGTGCG
CTCCGTAAATT -> TCCGTAAATTT
CTCCGTCAGCC -> TCCGTCAGCCA
CTCGATATTAA -> TCGATATTAAT
CTCGATGGCAC -> TCGATGGCACA
CTCGGAAAAAT -> TCGGAAAAATT
CTCGTAGTGGA -> TCGTAGTGGAG
CTCGTGAGTTA -> TCGTGAGTTAA
CTCTAATCGAG -> TCTAATCGAGC
CTCTATGAGTT -> TCTATGAGTTC
CTCTGACACAT -> TCTGACACATC
CTCTTTTTAGT -> TCTTTTTAGTG
CTGAAACGTAG -> TGAAACGTAGC
CTGACACATCG -> TGACACATCGC
CTGAGCGTGCC -> TGAGCGTGCCA
CTGAGGATATG -> TGAGGATATGG
CTGCCAGCCTC -> TGCCAGCCTCG
CTGCTTGATTT -> TGCTTGATTTA
CTGCTTGCGGC -> TGCTTGCGGCG
CTGGACTGCTT -> TGGACTGCTTG
CTGGAGGCATT -> TGGAGGCATTG
CTGGCAACTTG -> TGGCAACTTGG
CTGGCCGGCGG -> TGGCCGGCGGG
CTGGGTCGCGT -> TGGGTCGCGTT
CTGTATAATAC -> TGTATAATACT
CTGTATACCAA -> TGTATACCAAA
CTGTGGGCCCG -> TGTGGGCCCGC
CTGTTACGAAG -> TGTTACGAAGG
CTTAACCGCCA -> TTAACCGCCAC
CTTAATCTTAT -> TTAATCTTATA
CTTACGACTTG -> TTACGACTTGG
CTTACTCCGTC -> TTACTCCGTCA
CTTAGGAAGCA -> TTAGGAAGCAT
CTTATAACTAG -> TTATAACTAGC
CTTATACGGAG -> TTATACGGAGG
CTTATGTACAG -> TTATGTACAGC
CTTCAAGCAGA -> TTCAAGCAGAA
CTTCAATGGAG -> TTCAATGGAGG
CTTCAGTGGAG -> TTCAGTGGAGA
CTTCCAAATGC -> TTCCAAATGCA
CTTCCAGGGTG -> TTCCAGGGTGA
CTTCCCCGAGC -> TTCCCCGAGCA
CTTCCCCTGGA -> TTCCCCTGGAC
CTTCCCTACCA -> TTCCCTACCAA
CTTCCGGGAAC -> TTCCGGGAACC
CTTCGATAAGT -> TTCGATAAGTC
CTTCTGAGCGT -> TTCTGAGCGTG
CTTGAATCGTT -> TTGAATCGTTA
CTTGATTTATC -> TTGATTTATCA
CTTGCCAAAGC -> TTGCCAAAGCT
CTTGCGGCGTG -> TTGCGGCGTGG
CTTGGAATTCA -> TTGGAATTCAA
CTTGGAGCCCT -> TTGGAGCCCTC
CTTGGCGCTTC -> TTGGCGCTTCC
CTTGGTCTTGG -> TTGGTCTTGGT
CTTGGTTCAAA -> TTGGTTCAAAC
CTTGTGTTTGC -> TTGTGTTTGCA
CTTGTTGCCGG -> TTGTTGCCGGA
CTTTCAAGACT -> TTTCAAGACTT
CTTTTAATCTA -> TTTTAATCTAG
CTTTTTAGTGG -> TTTTTAGTGGC
CTTTTTGGTAG -> TTTTTGGTAGC
GAAAAATACTG -> AAAAATACTGT
GAAAAATTCTT -> AAAAATTCTTC
GAAAACGACGC -> AAAACGACGCT
GAAACGCAATC -> AAACGCAATCA
GAAACGTAGCT -> AAACGTAGCTT
GAAATCACGAG -> AAATCACGAGC
GAAATTTGAAT -> AAATTTGAATA
GAACAAACCAG -> AACAAACCAGC
GAACACCATCC -> AACACCATCCA
GAACCTCCAGA -> AACCTCCAGAT
GAACTCGGAAA -> AACTCGGAAAA
GAACTCTTTTT -> AACTCTTTTTA
GAAGCATAACT -> AAGCATAACTT
GAAGCGGAGTG -> AAGCGGAGTGA
GAAGGCGCGTT -> AAGGCGCGTTG
GAAGGCGTACA -> AAGGCGTACAT
GAAGTGTGGAG -> AAGTGTGGAGC
GAATAGAGCGT -> AATAGAGCGTT
GAATCCGACAA -> AATCCGACAAA
GAATCGTTATT -> AATCGTTATTT
GAATGTCGACA -> AATGTCGACAT
GAATTCAAGGT -> AATTCAAGGTC
GACAAAGTCCC -> ACAAAGTCCCG
GACACATCGCT -> ACACATCGCTA
GACACTAGAGT -> ACACTAGAGTG
GACAGCACAAC -> ACAGCACAACG
GACAGGGGGGG -> ACAGGGGGGGG
GACATCACAAA -> ACATCACAAAA
GACATTAGAAA -> ACATTAGAAAA
GACATTTGTGC -> ACATTTGTGCA
GACCATGGGAC -> ACCATGGGACC
GACCCCATCGA -> ACCCCATCGAT
GACCGACGCGG -> ACCGACGCGGA
GACCGTCCACG -> ACCGTCCACGA
GACCGTTTCTT -> ACCGTTTCTTC
GACCTAATTAC -> ACCTAATTACT
GACCTCCAGGT -> ACCTCCAGGTA
GACCTGTATAA -> ACCTGTATAAT
GACCTTATGTA -> ACCTTATGTAC
GACGACCTCCA -> ACGACCTCCAG
GACGACGCAAG -> ACGACGCAAGA
GACGAGTGGTC -> ACGAGTGGTCC
GACGATCGAGT -> ACGATCGAGTA
GACGATGAGTA -> ACGATGAGTAG
GACGCAAGAAG -> ACGCAAGAAGG
GACGCGGATGA -> ACGCGGATGAG
GACGCTTGTGT -> ACGCTTGTGTT
GACGTCTTATA -> ACGTCTTATAC
GACTCAATCTT -> ACTCAATCTTC
GACTCCCGCGT -> ACTCCCGCGTG
GACTGCTTGAT -> ACTGCTTGATT
GACTGGAGGCA -> ACTGGAGGCAT
GACTTCGATAA -> ACTTCGATAAG
GACTTCTGAGC -> ACTTCTGAGCG
GACTTGGCGCT -> ACTTGGCGCTT
GACTTTTTGGT -> ACTTTTTGGTA
GAGACCTGTAT -> AGACCTGTATA
GAGACTCCCGC -> AGACTCCCGCG
GAGACTTCTGA -> AGACTTCTGAG
GAGATTCATGC -> AGATTCATGCT
GAGATTGTCGC -> AGATTGTCGCA
GAGATTGTGTG -> AGATTGTGTGT
GAGCAACAATC -> AGCAACAATCT
GAGCAACACAA -> AGCAACACAAC
GAGCACATTTT -> AGCACATTTTC
GAGCATAATGC -> AGCATAATGCC
GAGCCCACGGA -> AGCCCACGGAC
GAGCCCTCGTA -> AGCCCTCGTAG
GAGCGACAGGG -> AGCGACAGGGG
GAGCGTGCCAT -> AGCGTGCCATG
GAGCGTGTATA -> AGCGTGTATAT
GAGCGTTCTCT -> AGCGTTCTCTG
GAGCTAGGGGA -> AGCTAGGGGAA
GAGGAGTACAT -> AGGAGTACATG
GAGGATATGGG -> AGGATATGGGA
GAGGCAAAAAT -> AGGCAAAAATC
GAGGCATTGCC -> AGGCATTGCCT
GAGGCCTCCAT -> AGGCCTCCATA
GAGGCGAGCCC -> AGGCGAGCCCA
GAGGCTTTCAA -> AGGCTTTCAAG
GAGGTGGTAAC -> AGGTGGTAACT
GAGGTTTGAGC -> AGGTTTGAGCT
GAGTACATGGG -> AGTACATGGGA
GAGTACCCGAG -> AGTACCCGAGG
GAGTACGTGAC -> AGTACGTGACG
GAGTAGAAGCG -> AGTAGAAGCGG
GAGTATTTTAA -> AGTATTTTAAA
GAGTCCTTGAA -> AGTCCTTGAAT
GAGTGAGTCCT -> AGTGAGTCCTT
GAGTGCAATGA -> AGTGCAATGAT
GAGTGCAGCCT -> AGTGCAGCCTG
GAGTGGTCCGA -> AGTGGTCCGAG
GAGTGGTGGGT -> AGTGGTGGGTA
GAGTTAAACCA -> AGTTAAACCAA
GAGTTACTTCC -> AGTTACTTCCA
GAGTTCCAATA -> AGTTCCAATAC
GATAAGTCAGT -> ATAAGTCAGTG
GATACCACACT -> ATACCACACTT
GATACCAGCGA -> ATACCAGCGAC
GATAGAGATTG -> ATAGAGATTGT
GATATGGGAGT -> ATATGGGAGTA
GATATTAATTA -> ATATTAATTAA
GATATTCATCA -> ATATTCATCAA
GATCGAGTACC -> ATCGAGTACCC
GATCGCCGCGA -> ATCGCCGCGAA
GATCTGCTTGC -> ATCTGCTTGCG
GATGACACTAG -> ATGACACTAGA
GATGACAGCAC -> ATGACAGCACA
GATGAGCGTGT -> ATGAGCGTGTA
GATGAGTAGAA -> ATGAGTAGAAG
GATGGCACATC -> ATGGCACATCG
GATGGGACCTA -> ATGGGACCTAA
GATGTCGTAGG -> ATGTCGTAGGT
GATTCATGCTT -> ATTCATGCTTG
GATTGTCGCAT -> ATTGTCGCATT
GATTGTGTGTC -> ATTGTGTGTCG
GATTTATCAGT -> ATTTATCAGTA
GATTTTACATA -> ATTTTACATAT
GCAAAAATCAA -> CAAAAATCAAC
GCAACAATCTA -> CAACAATCTAT
GCAACACAACG -> CAACACAACGA
GCAACCGCAGA -> CAACCGCAGAT
GCAACCTCCCT -> CAACCTCCCTA
GCAACTTGGTC -> CAACTTGGTCT
GCAAGAAGGCG -> CAAGAAGGCGT
GCAAGCTCGAT -> CAAGCTCGATG
GCAATCAAGTA -> CAATCAAGTAG
GCAATGATAGA -> CAATGATAGAG
GCACAACGGAC -> CACAACGGACG
GCACAACGGAG -> CACAACGGAGT
GCACATCGAAA -> CACATCGAAAA
GCACATTTTCA -> CACATTTTCAC
GCACCAGACCG -> CACCAGACCGT
GCACGTGTGTC -> CACGTGTGTCC
GCACTAGAACT -> CACTAGAACTC
GCAGAATCCGA -> CAGAATCCGAC
GCAGATTTTAC -> CAGATTTTACA
GCAGCCTGTAT -> CAGCCTGTATA
GCATAACTTCA -> CATAACTTCAA
GCATAATGCCA -> CATAATGCCAT
GCATCATTGAT -> CATCATTGATA
GCATTCCTCCG -> CATTCCTCCGT
GCATTCGACGA -> CATTCGACGAC
GCATTGCCTCT -> CATTGCCTCTA
GCATTGTTCTT -> CATTGTTCTTC
GCATTTCTGGC -> CATTTCTGGCA
GCCAAAGCTCC -> CCAAAGCTCCC
GCCACCTATAA -> CCACCTATAAA
GCCAGAAACGC -> CCAGAAACGCA
GCCAGCCTCGT -> CCAGCCTCGTG
GCCATAGATAC -> CCATAGATACC
GCCATGTCTTA -> CCATGTCTTAC
GCCATTCGGGA -> CCATTCGGGAA
GCCATTCTTGT -> CCATTCTTGTT
GCCCACGGACG -> CCCACGGACGA
GCCCGCGGGGT -> CCCGCGGGGTA
GCCCTCGTAGT -> CCCTCGTAGTG
GCCGCGAAATC -> CCGCGAAATCA
GCCGGACGATC -> CCGGACGATCG
GCCGGCGGGCT -> CCGGCGGGCTC
GCCGGTGTAAG -> CCGGTGTAAGT
GCCGTTGAAGT -> CCGTTGAAGTG
GCCGTTTCCAT -> CCGTTTCCATC
GCCTCCATAAG -> CCTCCATAAGT
GCCTCGTGAGT -> CCTCGTGAGTT
GCCTCTATGAG -> CCTCTATGAGT
GCCTGTATACC -> CCTGTATACCA
GCGAAATCACG -> CGAAATCACGA
GCGACAGGGGG -> CGACAGGGGGG
GCGACGATGAG -> CGACGATGAGT
GCGAGACTTCT -> CGAGACTTCTG
GCGAGCCCACG -> CGAGCCCACGG
GCGAGGCTTTC -> CGAGGCTTTCA
GCGATCTGCTT -> CGATCTGCTTG
GCGCGAGACTT -> CGCGAGACTTC
GCGCGGTCGAG -> CGCGGTCGAGA
GCGCGTTGCTT -> CGCGTTGCTTG
GCGCTTCCGGG -> CGCTTCCGGGA
GCGGAGTGAGT -> CGGAGTGAGTC
GCGGATGAGCG -> CGGATGAGCGT
GCGGCGTGGTC -> CGGCGTGGTCC
GCGGCTATCGA -> CGGCTATCGAG
GCGGGCTCAGA -> CGGGCTCAGAC
GCGGGGTAACG -> CGGGGTAACGT
GCGGTCGAGAC -> CGGTCGAGACT
GCGTACATATT -> CGTACATATTT
GCGTGAGTTAC -> CGTGAGTTACT
GCGTGCCATGT -> CGTGCCATGTC
GCGTGGTCCAA -> CGTGGTCCAAG
GCGTGTATATA -> CGTGTATATAG
GCGTTCTCTGA -> CGTTCTCTGAC
GCGTTGCTTGC -> CGTTGCTTGCC
GCGTTTGGCCG -> CGTTTGGCCGT
GCTAGGGGAAC -> CTAGGGGAACA
GCTATCGAGGC -> CTATCGAGGCG
GCTATGCAACC -> CTATGCAACCT
GCTCAGACCCC -> CTCAGACCCCA
GCTCCCGAAAT -> CTCCCGAAATT
GCTCGATGGCA -> CTCGATGGCAC
GCTGGGTCGCG -> CTGGGTCGCGT
GCTTAACCGCC -> CTTAACCGCCA
GCTTCCGGGAA -> CTTCCGGGAAC
GCTTGATTTAT -> CTTGATTTATC
GCTTGCCAAAG -> CTTGCCAAAGC
GCTTGCGGCGT -> CTTGCGGCGTG
GCTTGGAATTC -> CTTGGAATTCA
GCTTGGAGCCC -> CTTGGAGCCCT
GCTTGTGTTTG -> CTTGTGTTTGC
GCTTTCAAGAC -> CTTTCAAGACT
GGAAAAATTCT -> GAAAAATTCTT
GGAACAAACCA -> GAACAAACCAG
GGAACCTCCAG -> GAACCTCCAGA
GGAAGCATAAC -> GAAGCATAACT
GGAATGTCGAC -> GAATGTCGACA
GGAATTCAAGG -> GAATTCAAGGT
GGACATCACAA -> GACATCACAAA
GGACCATGGGA -> GACCATGGGAC
GGACCTAATTA -> GACCTAATTAC
GGACCTTATGT -> GACCTTATGTA
GGACGACGCAA -> GACGACGCAAG
GGACGAGTGGT -> GACGAGTGGTC
GGACGATCGAG -> GACGATCGAGT
GGACTGCTTGA -> GACTGCTTGAT
GGACTTCGATA -> GACTTCGATAA
GGAGACCTGTA -> GAGACCTGTAT
GGAGCATAATG -> GAGCATAATGC
GGAGCCCTCGT -> GAGCCCTCGTA
GGAGCGACAGG -> GAGCGACAGGG
GGAGGAGTACA -> GAGGAGTACAT
GGAGGCATTGC -> GAGGCATTGCC
GGAGGTGGTAA -> GAGGTGGTAAC
GGAGTACATGG -> GAGTACATGGG
GGAGTACGTGA -> GAGTACGTGAC
GGAGTGAGTCC -> GAGTGAGTCCT
GGAGTGCAGCC -> GAGTGCAGCCT
GGAGTGGTGGG -> GAGTGGTGGGT
GGATATGGGAG -> GATATGGGAGT
GGATGACACTA -> GATGACACTAG
GGATGAGCGTG -> GATGAGCGTGT
GGCAAAAATCA -> GCAAAAATCAA
GGCAACTTGGT -> GCAACTTGGTC
GGCACATCGAA -> GCACATCGAAA
GGCACCAGACC -> GCACCAGACCG
GGCACTAGAAC -> GCACTAGAACT
GGCATTGCCTC -> GCATTGCCTCT
GGCCCGCGGGG -> GCCCGCGGGGT
GGCCGGCGGGC -> GCCGGCGGGCT
GGCCGGTGTAA -> GCCGGTGTAAG
GGCCGTTGAAG -> GCCGTTGAAGT
GGCCGTTTCCA -> GCCGTTTCCAT
GGCCTCCATAA -> GCCTCCATAAG
GGCGAGCCCAC -> GCGAGCCCACG
GGCGCGGTCGA -> GCGCGGTCGAG
GGCGCGTTGCT -> GCGCGTTGCTT
GGCGCTTCCGG -> GCGCTTCCGGG
GGCGGGCTCAG -> GCGGGCTCAGA
GGCGTACATAT -> GCGTACATATT
GGCGTGGTCCA -> GCGTGGTCCAA
GGCTATCGAGG -> GCTATCGAGGC
GGCTCAGACCC -> GCTCAGACCCC
GGCTTTCAAGA -> GCTTTCAAGAC
GGGAACAAACC -> GGAACAAACCA
GGGAACCTCCA -> GGAACCTCCAG
GGGAATGTCGA -> GGAATGTCGAC
GGGACCATGGG -> GGACCATGGGA
GGGACCTAATT -> GGACCTAATTA
GGGACCTTATG -> GGACCTTATGT
GGGAGTACGTG -> GGAGTACGTGA
GGGCCCGCGGG -> GGCCCGCGGGG
GGGCGCGGTCG -> GGCGCGGTCGA
GGGCTCAGACC -> GGCTCAGACCC
GGGGAACAAAC -> GGGAACAAACC
GGGGCGCGGTC -> GGGCGCGGTCG
GGGGGCGCGGT -> GGGGCGCGGTC
GGGGGGCGCGG -> GGGGGCGCGGT
GGGGGGGCGCG -> GGGGGGCGCGG
GGGGGGGGCGC -> GGGGGGGCGCG
GGGGTAACGTG -> GGGTAACGTGG
GGGTAACGTGG -> GGTAACGTGGC
GGGTAAGAGTA -> GGTAAGAGTAT
GGGTCGCGTTT -> GGTCGCGTTTG
GGGTGACTGGA -> GGTGACTGGAG
GGGTGGACATC -> GGTGGACATCA
GGTAACGTGGC -> GTAACGTGGCC
GGTAACTTCAA -> GTAACTTCAAG
GGTAAGAGTAT -> GTAAGAGTATT
GGTAGCCATAG -> GTAGCCATAGA
GGTAGCGCGAG -> GTAGCGCGAGA
GGTATCATAAC -> GTATCATAACG
GGTCCAAGTGT -> GTCCAAGTGTC
GGTCCGAGGCC -> GTCCGAGGCCT
GGTCCTGGCCG -> GTCCTGGCCGG
GGTCGAGACTC -> GTCGAGACTCC
GGTCGCGTTTG -> GTCGCGTTTGG
GGTCTTGGTTC -> GTCTTGGTTCA
GGTGACTGGAG -> GTGACTGGAGG
GGTGGACATCA -> GTGGACATCAC
GGTGGGTAAGA -> GTGGGTAAGAG
GGTGGTAACTT -> GTGGTAACTTC
GGTGTAAGTAG -> GTGTAAGTAGC
GGTGTGCGATC -> GTGTGCGATCT
GGTTCAAACTT -> GTTCAAACTTA
GGTTCCTGCCA -> GTTCCTGCCAG
GGTTTCGTATC -> GTTTCGTATCA
GGTTTGAGCTA -> GTTTGAGCTAG
GTAAATTTAAC -> TAAATTTAACC
GTAACGTGGCC -> TAACGTGGCCG
GTAACTATGTC -> TAACTATGTCG
GTAACTTCAAG -> TAACTTCAAGC
GTAAGAGTATT -> TAAGAGTATTT
GTAAGTAGCAT -> TAAGTAGCATC
GTACAGCACGT -> TACAGCACGTG
GTACATATTTC -> TACATATTTCT
GTACATGGGAC -> TACATGGGACC
GTACCCGAGGC -> TACCCGAGGCA
GTACGTGACGT -> TACGTGACGTC
GTACTACCCGA -> TACTACCCGAT
GTAGAAGCGGA -> TAGAAGCGGAG
GTAGCATCATT -> TAGCATCATTG
GTAGCCATAGA -> TAGCCATAGAT
GTAGCGCGAGA -> TAGCGCGAGAC
GTAGCTTGGAG -> TAGCTTGGAGC
GTAGGGTGGAC -> TAGGGTGGACA
GTAGGTTCCTG -> TAGGTTCCTGC
GTAGTGCTGGG -> TAGTGCTGGGT
GTAGTGGAGTG -> TAGTGGAGTGG
GTAGTTGTATC -> TAGTTGTATCT
GTATAATACTG -> TATAATACTGA
GTATACCAAAC -> TATACCAAACA
GTATATAGTCT -> TATATAGTCTT
GTATCATAACG -> TATCATAACGT
GTATCATGCCA -> TATCATGCCAG
GTATCTGAGGA -> TATCTGAGGAT
GTATTTTAAAA -> TATTTTAAAAC
GTATTTTTCAA -> TATTTTTCAAG
GTCAGCCATTC -> TCAGCCATTCG
GTCAGTGGTAG -> TCAGTGGTAGC
GTCATGAGGTT -> TCATGAGGTTT
GTCCAAGTGTC -> TCCAAGTGTCA
GTCCACGATAT -> TCCACGATATT
GTCCCGACCGA -> TCCCGACCGAC
GTCCCTGTTAC -> TCCCTGTTACG
GTCCGAGATTC -> TCCGAGATTCA
GTCCGAGGCCT -> TCCGAGGCCTC
GTCCTGGCCGG -> TCCTGGCCGGC
GTCCTTGAATC -> TCCTTGAATCG
GTCGACATTAG -> TCGACATTAGA
GTCGACATTTG -> TCGACATTTGT
GTCGACCGTTT -> TCGACCGTTTC
GTCGAGACTCC -> TCGAGACTCCC
GTCGCATTCGA -> TCGCATTCGAC
GTCGCGTTTGG -> TCGCGTTTGGC
GTCGTAGGTTC -> TCGTAGGTTCC
GTCGTCGACCG -> TCGTCGACCGT
GTCTTAATCTT -> TCTTAATCTTA
GTCTTACTCCG -> TCTTACTCCGT
GTCTTATACGG -> TCTTATACGGA
GTCTTGGTTCA -> TCTTGGTTCAA
GTGACGTCTTA -> TGACGTCTTAT
GTGACTGGAGG -> TGACTGGAGGC
GTGAGTCCTTG -> TGAGTCCTTGA
GTGAGTTAAAC -> TGAGTTAAACC
GTGAGTTACTT -> TGAGTTACTTC
GTGCAACCGCA -> TGCAACCGCAG
GTGCAATGATA -> TGCAATGATAG
GTGCAGCCTGT -> TGCAGCCTGTA
GTGCATTGTTC -> TGCATTGTTCT
GTGCCATGTCT -> TGCCATGTCTT
GTGCGATCTGC -> TGCGATCTGCT
GTGCGGCTATC -> TGCGGCTATCG
GTGCTGGGTCG -> TGCTGGGTCGC
GTGCTTAACCG -> TGCTTAACCGC
GTGGACATCAC -> TGGACATCACA
GTGGAGACCTG -> TGGAGACCTGT
GTGGAGCGACA -> TGGAGCGACAG
GTGGAGTGGTG -> TGGAGTGGTGG
GTGGATGACAC -> TGGATGACACT
GTGGCACCAGA -> TGGCACCAGAC
GTGGCACTAGA -> TGGCACTAGAA
GTGGCCGTTTC -> TGGCCGTTTCC
GTGGGCCCGCG -> TGGGCCCGCGG
GTGGGTAAGAG -> TGGGTAAGAGT
GTGGTAACTTC -> TGGTAACTTCA
GTGGTAGCCAT -> TGGTAGCCATA
GTGGTCCAAGT -> TGGTCCAAGTG
GTGGTCCGAGG -> TGGTCCGAGGC
GTGGTGGGTAA -> TGGTGGGTAAG
GTGTAAGTAGC -> TGTAAGTAGCA
GTGTATATAGT -> TGTATATAGTC
GTGTCATGAGG -> TGTCATGAGGT
GTGTCCCTGTT -> TGTCCCTGTTA
GTGTCGTCGAC -> TGTCGTCGACC
GTGTGCGATCT -> TGTGCGATCTG
GTGTGGAGCGA -> TGTGGAGCGAC
GTGTGTCCCTG -> TGTGTCCCTGT
GTGTGTCGTCG -> TGTGTCGTCGA
GTGTTTGCACA -> TGTTTGCACAA
GTTAAACCAAG -> TTAAACCAAGC
GTTACGAAGGC -> TTACGAAGGCG
GTTACTTCCAA -> TTACTTCCAAA
GTTAGGCCGGT -> TTAGGCCGGTG
GTTATTTTTGT -> TTATTTTTGTA
GTTCAAACTTA -> TTCAAACTTAC
GTTCCAATACA -> TTCCAATACAT
GTTCCTGCCAG -> TTCCTGCCAGC
GTTCTCTGACA -> TTCTCTGACAC
GTTCTTCAGTG -> TTCTTCAGTGG
GTTGAAGTGTG -> TTGAAGTGTGG
GTTGCCGGACG -> TTGCCGGACGA
GTTGCTTGCCA -> TTGCTTGCCAA
GTTGTATCTGA -> TTGTATCTGAG
GTTTCCATCCG -> TTTCCATCCGG
GTTTCGTATCA -> TTTCGTATCAT
GTTTCTTCCAG -> TTTCTTCCAGG
GTTTGAGCTAG -> TTTGAGCTAGG
GTTTGCACAAC -> TTTGCACAACG
GTTTGGCCGTT -> TTTGGCCGTTG
TAAAACAGCAA -> AAAACAGCAAG
TAAAAGTGGAT -> AAAAGTGGATG
TAAACCAAGCA -> AAACCAAGCAT
TAAATTTAACC -> AAATTTAACCT
TAACCGCCACC -> AACCGCCACCT
TAACCTCGATA -> AACCTCGATAT
TAACGTAGTTG -> AACGTAGTTGT
TAACGTGGCCG -> AACGTGGCCGT
TAACTATGTCG -> AACTATGTCGA
TAACTTCAAGC -> AACTTCAAGCA
TAACTTCAATG -> AACTTCAATGG
TAAGAGTATTT -> AAGAGTATTTT
TAAGTAGCATC -> AAGTAGCATCA
TAAGTCAGTGG -> AAGTCAGTGGT
TAAGTGCTTAA -> AAGTGCTTAAC
TAAGTGGCACT -> AAGTGGCACTA
TAATACTGAAA -> AATACTGAAAC
TAATCGAGCAA -> AATCGAGCAAC
TAATCTAGACT -> AATCTAGACTC
TAATCTTATAA -> AATCTTATAAC
TAATGCCATTC -> AATGCCATTCT
TAATGGTTTCG -> AATGGTTTCGT
TAATTAATGGT -> AATTAATGGTT
TAATTACTAAG -> AATTACTAAGT
TACAGCACGTG -> ACAGCACGTGT
TACATATATTA -> ACATATATTAG
TACATATTTCT -> ACATATTTCTC
TACATGGGACC -> ACATGGGACCA
TACATTTAGGA -> ACATTTAGGAG
TACCAAAAAAC -> ACCAAAAAACT
TACCAAACATT -> ACCAAACATTT
TACCACACTTC -> ACCACACTTCC
TACCAGCGACG -> ACCAGCGACGA
TACCCGAGGCA -> ACCCGAGGCAA
TACCCGATGGG -> ACCCGATGGGA
TACGAAGGCGC -> ACGAAGGCGCG
TACGACTTGGC -> ACGACTTGGCG
TACGGAGGAGT -> ACGGAGGAGTA
TACGTGACGTC -> ACGTGACGTCT
TACTAAGTGGC -> ACTAAGTGGCA
TACTACCCGAT -> ACTACCCGATG
TACTCCGTCAG -> ACTCCGTCAGC
TACTGAAACGT -> ACTGAAACGTA
TACTGTGGGCC -> ACTGTGGGCCC
TACTTCCAAAT -> ACTTCCAAATG
TAGAAAAATAC -> AGAAAAATACT
TAGAACTCGGA -> AGAACTCGGAA
TAGAAGCGGAG -> AGAAGCGGAGT
TAGACTCAATC -> AGACTCAATCT
TAGAGATTGTC -> AGAGATTGTCG
TAGAGCGTTCT -> AGAGCGTTCTC
TAGAGTGCAAT -> AGAGTGCAATG
TAGATACCACA -> AGATACCACAC
TAGCATCATTG -> AGCATCATTGA
TAGCCATAGAT -> AGCCATAGATA
TAGCGCGAGAC -> AGCGCGAGACT
TAGCTTGGAGC -> AGCTTGGAGCC
TAGGAAGCATA -> AGGAAGCATAA
TAGGAGCATAA -> AGGAGCATAAT
TAGGCCGGTGT -> AGGCCGGTGTA
TAGGGGAACAA -> AGGGGAACAAA
TAGGGTGGACA -> AGGGTGGACAT
TAGGTTCCTGC -> AGGTTCCTGCC
TAGTCCGAGAT -> AGTCCGAGATT
TAGTCTTAATC -> AGTCTTAATCT
TAGTGCGGCTA -> AGTGCGGCTAT
TAGTGCTGGGT -> AGTGCTGGGTC
TAGTGGAGTGG -> AGTGGAGTGGT
TAGTGGCACCA -> AGTGGCACCAG
TAGTTGTATCT -> AGTTGTATCTG
TATAAAAGTGG -> ATAAAAGTGGA
TATAATACTGA -> ATAATACTGAA
TATACCAAACA -> ATACCAAACAT
TATACGGAGGA -> ATACGGAGGAG
TATAGTCTTAA -> ATAGTCTTAAT
TATATAGTCTT -> ATATAGTCTTA
TATATTAGTCC -> ATATTAGTCCG
TATCAGTATTT -> ATCAGTATTTT
TATCATAACGT -> ATCATAACGTA
TATCATGCCAG -> ATCATGCCAGA
TATCGAACTCT -> ATCGAACTCTT
TATCGAGGCGA -> ATCGAGGCGAG
TATCTGAGGAT -> ATCTGAGGATA
TATGAGTTCCA -> ATGAGTTCCAA
TATGCAACCTC -> ATGCAACCTCC
TATGGGAGTAC -> ATGGGAGTACG
TATGTACAGCA -> ATGTACAGCAC
TATGTCGACAT -> ATGTCGACATT
TATTAATTAAT -> ATTAATTAATG
TATTAGTCCGA -> ATTAGTCCGAG
TATTCATCAAA -> ATTCATCAAAT
TATTTCTCTAA -> ATTTCTCTAAT
TATTTTAAAAC -> ATTTTAAAACA
TATTTTTCAAG -> ATTTTTCAAGT
TATTTTTGTAC -> ATTTTTGTACT
TCAAACTTACG -> CAAACTTACGA
TCAAATGAGAT -> CAAATGAGATT
TCAACCGTGCA -> CAACCGTGCAA
TCAAGACTTTT -> CAAGACTTTTT
TCAAGCAGAAT -> CAAGCAGAATC
TCAAGGTCCTG -> CAAGGTCCTGG
TCAAGTAGGGT -> CAAGTAGGGTG
TCAAGTTAGGC -> CAAGTTAGGCC
TCAATCTTCCC -> CAATCTTCCCC
TCAATGGAGGT -> CAATGGAGGTG
TCACAAAAGGA -> CACAAAAGGAC
TCACCAGAACA -> CACCAGAACAC
TCACGAGCACA -> CACGAGCACAT
TCAGACCCCAT -> CAGACCCCATC
TCAGCCATTCG -> CAGCCATTCGG
TCAGTATTTTT -> CAGTATTTTTC
TCAGTGGAGAC -> CAGTGGAGACC
TCAGTGGTAGC -> CAGTGGTAGCC
TCATAACGTAG -> CATAACGTAGT
TCATCAAATGA -> CATCAAATGAG
TCATGAGGTTT -> CATGAGGTTTG
TCATGCCAGAA -> CATGCCAGAAA
TCATGCTTGGA -> CATGCTTGGAA
TCATTGATACC -> CATTGATACCA
TCCAAATGCAT -> CCAAATGCATT
TCCAAGTGTCA -> CCAAGTGTCAT
TCCAATACATT -> CCAATACATTT
TCCACGATATT -> CCACGATATTC
TCCACTTAGGA -> CCACTTAGGAA
TCCAGATGTCG -> CCAGATGTCGT
TCCAGGGTGAC -> CCAGGGTGACT
TCCAGGTATCA -> CCAGGTATCAT
TCCATAAGTGC -> CCATAAGTGCT
TCCATCCGGTG -> CCATCCGGTGT
TCCCCGAGCAA -> CCCCGAGCAAC
TCCCCTGGACT -> CCCCTGGACTG
TCCCGAAATTT -> CCCGAAATTTG
TCCCGACCGAC -> CCCGACCGACG
TCCCGCGTGAG -> CCCGCGTGAGT
TCCCTACCAAA -> CCCTACCAAAA
TCCCTAGTGCG -> CCCTAGTGCGG
TCCCTGTTACG -> CCCTGTTACGA
TCCGACAAAGT -> CCGACAAAGTC
TCCGAGATTCA -> CCGAGATTCAT
TCCGAGGCCTC -> CCGAGGCCTCC
TCCGGGAACCT -> CCGGGAACCTC
TCCGGTGTGCG -> CCGGTGTGCGA
TCCGTAAATTT -> CCGTAAATTTA
TCCGTCAGCCA -> CCGTCAGCCAT
TCCTCCGTAAA -> CCTCCGTAAAT
TCCTGCCAGCC -> CCTGCCAGCCT
TCCTGGCCGGC -> CCTGGCCGGCG
TCCTTGAATCG -> CCTTGAATCGT
TCGAAAACGAC -> CGAAAACGACG
TCGAACTCTTT -> CGAACTCTTTT
TCGACATTAGA -> CGACATTAGAA
TCGACATTTGT -> CGACATTTGTG
TCGACCGTTTC -> CGACCGTTTCT
TCGACGACCTC -> CGACGACCTCC
TCGAGACTCCC -> CGAGACTCCCG
TCGAGCAACAA -> CGAGCAACAAT
TCGAGGCGAGC -> CGAGGCGAGCC
TCGAGTACCCG -> CGAGTACCCGA
TCGATAAGTCA -> CGATAAGTCAG
TCGATATTAAT -> CGATATTAATT
TCGATCGCCGC -> CGATCGCCGCG
TCGATGGCACA -> CGATGGCACAT
TCGCATTCGAC -> CGCATTCGACG
TCGCCGCGAAA -> CGCCGCGAAAT
TCGCGTTTGGC -> CGCGTTTGGCC
TCGCTATGCAA -> CGCTATGCAAC
TCGGAAAAATT -> CGGAAAAATTC
TCGGGAATGTC -> CGGGAATGTCG
TCGTAGGTTCC -> CGTAGGTTCCT
TCGTAGTGGAG -> CGTAGTGGAGT
TCGTATCATGC -> CGTATCATGCC
TCGTCGACCGT -> CGTCGACCGTT
TCGTGAGTTAA -> CGTGAGTTAAA
TCGTTATTTTT -> CGTTATTTTTG
TCTAATCGAGC -> CTAATCGAGCA
TCTAGACTCAA -> CTAGACTCAAT
TCTATCGAACT -> CTATCGAACTC
TCTATGAGTTC -> CTATGAGTTCC
TCTCTAATCGA -> CTCTAATCGAG
TCTCTGACACA -> CTCTGACACAT
TCTGACACATC -> CTGACACATCG
TCTGAGCGTGC -> CTGAGCGTGCC
TCTGAGGATAT -> CTGAGGATATG
TCTGCTTGCGG -> CTGCTTGCGGC
TCTGGCAACTT -> CTGGCAACTTG
TCTTAATCTTA -> CTTAATCTTAT
TCTTACTCCGT -> CTTACTCCGTC
TCTTATAACTA -> CTTATAACTAG
TCTTATACGGA -> CTTATACGGAG
TCTTCAGTGGA -> CTTCAGTGGAG
TCTTCCAGGGT -> CTTCCAGGGTG
TCTTCCCCGAG -> CTTCCCCGAGC
TCTTCCCTACC -> CTTCCCTACCA
TCTTGGTTCAA -> CTTGGTTCAAA
TCTTGTTGCCG -> CTTGTTGCCGG
TCTTTTTAGTG -> CTTTTTAGTGG
TGAAACGTAGC -> GAAACGTAGCT
TGAAGTGTGGA -> GAAGTGTGGAG
TGAATAGAGCG -> GAATAGAGCGT
TGAATCGTTAT -> GAATCGTTATT
TGACACATCGC -> GACACATCGCT
TGACACTAGAG -> GACACTAGAGT
TGACAGCACAA -> GACAGCACAAC
TGACGTCTTAT -> GACGTCTTATA
TGACTGGAGGC -> GACTGGAGGCA
TGAGATTGTGT -> GAGATTGTGTG
TGAGCGTGCCA -> GAGCGTGCCAT
TGAGCGTGTAT -> GAGCGTGTATA
TGAGCTAGGGG -> GAGCTAGGGGA
TGAGGATATGG -> GAGGATATGGG
TGAGGTTTGAG -> GAGGTTTGAGC
TGAGTAGAAGC -> GAGTAGAAGCG
TGAGTCCTTGA -> GAGTCCTTGAA
TGAGTTAAACC -> GAGTTAAACCA
TGAGTTACTTC -> GAGTTACTTCC
TGAGTTCCAAT -> GAGTTCCAATA
TGATACCAGCG -> GATACCAGCGA
TGATAGAGATT -> GATAGAGATTG
TGATTTATCAG -> GATTTATCAGT
TGCAACCGCAG -> GCAACCGCAGA
TGCAACCTCCC -> GCAACCTCCCT
TGCAATGATAG -> GCAATGATAGA
TGCACAACGGA -> GCACAACGGAC
TGCAGCCTGTA -> GCAGCCTGTAT
TGCATTGTTCT -> GCATTGTTCTT
TGCATTTCTGG -> GCATTTCTGGC
TGCCAAAGCTC -> GCCAAAGCTCC
TGCCAGAAACG -> GCCAGAAACGC
TGCCAGCCTCG -> GCCAGCCTCGT
TGCCATGTCTT -> GCCATGTCTTA
TGCCATTCTTG -> GCCATTCTTGT
TGCCGGACGAT -> GCCGGACGATC
TGCCTCTATGA -> GCCTCTATGAG
TGCGATCTGCT -> GCGATCTGCTT
TGCGGCGTGGT -> GCGGCGTGGTC
TGCGGCTATCG -> GCGGCTATCGA
TGCTGGGTCGC -> GCTGGGTCGCG
TGCTTAACCGC -> GCTTAACCGCC
TGCTTGATTTA -> GCTTGATTTAT
TGCTTGCCAAA -> GCTTGCCAAAG
TGCTTGCGGCG -> GCTTGCGGCGT
TGCTTGGAATT -> GCTTGGAATTC
TGGAATTCAAG -> GGAATTCAAGG
TGGACATCACA -> GGACATCACAA
TGGACTGCTTG -> GGACTGCTTGA
TGGAGACCTGT -> GGAGACCTGTA
TGGAGCCCTCG -> GGAGCCCTCGT
TGGAGCGACAG -> GGAGCGACAGG
TGGAGGCATTG -> GGAGGCATTGC
TGGAGGTGGTA -> GGAGGTGGTAA
TGGAGTGGTGG -> GGAGTGGTGGG
TGGATGACACT -> GGATGACACTA
TGGCAACTTGG -> GGCAACTTGGT
TGGCACATCGA -> GGCACATCGAA
TGGCACCAGAC -> GGCACCAGACC
TGGCACTAGAA -> GGCACTAGAAC
TGGCCGGCGGG -> GGCCGGCGGGC
TGGCCGTTGAA -> GGCCGTTGAAG
TGGCCGTTTCC -> GGCCGTTTCCA
TGGCGCTTCCG -> GGCGCTTCCGG
TGGGACCATGG -> GGGACCATGGG
TGGGACCTAAT -> GGGACCTAATT
TGGGACCTTAT -> GGGACCTTATG
TGGGAGTACGT -> GGGAGTACGTG
TGGGCCCGCGG -> GGGCCCGCGGG
TGGGTAAGAGT -> GGGTAAGAGTA
TGGGTCGCGTT -> GGGTCGCGTTT
TGGTAACTTCA -> GGTAACTTCAA
TGGTAGCCATA -> GGTAGCCATAG
TGGTAGCGCGA -> GGTAGCGCGAG
TGGTCCAAGTG -> GGTCCAAGTGT
TGGTCCGAGGC -> GGTCCGAGGCC
TGGTCTTGGTT -> GGTCTTGGTTC
TGGTGGGTAAG -> GGTGGGTAAGA
TGGTTCAAACT -> GGTTCAAACTT
TGGTTTCGTAT -> GGTTTCGTATC
TGTAACTATGT -> GTAACTATGTC
TGTAAGTAGCA -> GTAAGTAGCAT
TGTACAGCACG -> GTACAGCACGT
TGTACTACCCG -> GTACTACCCGA
TGTATAATACT -> GTATAATACTG
TGTATACCAAA -> GTATACCAAAC
TGTATATAGTC -> GTATATAGTCT
TGTATCTGAGG -> GTATCTGAGGA
TGTCATGAGGT -> GTCATGAGGTT
TGTCCCTGTTA -> GTCCCTGTTAC
TGTCGACATTA -> GTCGACATTAG
TGTCGACATTT -> GTCGACATTTG
TGTCGCATTCG -> GTCGCATTCGA
TGTCGTAGGTT -> GTCGTAGGTTC
TGTCGTCGACC -> GTCGTCGACCG
TGTCTTACTCC -> GTCTTACTCCG
TGTGCATTGTT -> GTGCATTGTTC
TGTGCGATCTG -> GTGCGATCTGC
TGTGGAGCGAC -> GTGGAGCGACA
TGTGGGCCCGC -> GTGGGCCCGCG
TGTGTCCCTGT -> GTGTCCCTGTT
TGTGTCGTCGA -> GTGTCGTCGAC
TGTGTGTCGTC -> GTGTGTCGTCG
TGTGTTTGCAC -> GTGTTTGCACA
TGTTACGAAGG -> GTTACGAAGGC
TGTTCTTCAGT -> GTTCTTCAGTG
TGTTGCCGGAC -> GTTGCCGGACG
TGTTTGCACAA -> GTTTGCACAAC
TTAAAACAGCA -> TAAAACAGCAA
TTAAACCAAGC -> TAAACCAAGCA
TTAACCGCCAC -> TAACCGCCACC
TTAACCTCGAT -> TAACCTCGATA
TTAATCTAGAC -> TAATCTAGACT
TTAATCTTATA -> TAATCTTATAA
TTAATGGTTTC -> TAATGGTTTCG
TTAATTAATGG -> TAATTAATGGT
TTACATATATT -> TACATATATTA
TTACGAAGGCG -> TACGAAGGCGC
TTACGACTTGG -> TACGACTTGGC
TTACTAAGTGG -> TACTAAGTGGC
TTACTCCGTCA -> TACTCCGTCAG
TTACTTCCAAA -> TACTTCCAAAT
TTAGAAAAATA -> TAGAAAAATAC
TTAGGAAGCAT -> TAGGAAGCATA
TTAGGAGCATA -> TAGGAGCATAA
TTAGGCCGGTG -> TAGGCCGGTGT
TTAGTCCGAGA -> TAGTCCGAGAT
TTAGTGGCACC -> TAGTGGCACCA
TTATAACTAGC -> TATAACTAGCA
TTATACGGAGG -> TATACGGAGGA
TTATCAGTATT -> TATCAGTATTT
TTATGTACAGC -> TATGTACAGCA
TTATTTTTGTA -> TATTTTTGTAC
TTCAAACTTAC -> TCAAACTTACG
TTCAAGACTTT -> TCAAGACTTTT
TTCAAGCAGAA -> TCAAGCAGAAT
TTCAAGGTCCT -> TCAAGGTCCTG
TTCAAGTTAGG -> TCAAGTTAGGC
TTCAATGGAGG -> TCAATGGAGGT
TTCACCAGAAC -> TCACCAGAACA
TTCAGTGGAGA -> TCAGTGGAGAC
TTCATCAAATG -> TCATCAAATGA
TTCATGCTTGG -> TCATGCTTGGA
TTCCAAATGCA -> TCCAAATGCAT
TTCCAATACAT -> TCCAATACATT
TTCCAGGGTGA -> TCCAGGGTGAC
TTCCATCCGGT -> TCCATCCGGTG
TTCCCCGAGCA -> TCCCCGAGCAA
TTCCCCTGGAC -> TCCCCTGGACT
TTCCCTACCAA -> TCCCTACCAAA
TTCCGGGAACC -> TCCGGGAACCT
TTCCTCCGTAA -> TCCTCCGTAAA
TTCCTGCCAGC -> TCCTGCCAGCC
TTCGACGACCT -> TCGACGACCTC
TTCGATAAGTC -> TCGATAAGTCA
TTCGGGAATGT -> TCGGGAATGTC
TTCGTATCATG -> TCGTATCATGC
TTCTCTAATCG -> TCTCTAATCGA
TTCTCTGACAC -> TCTCTGACACA
TTCTGAGCGTG -> TCTGAGCGTGC
TTCTGGCAACT -> TCTGGCAACTT
TTCTTCAGTGG -> TCTTCAGTGGA
TTCTTCCAGGG -> TCTTCCAGGGT
TTCTTCCCTAC -> TCTTCCCTACC
TTCTTGTTGCC -> TCTTGTTGCCG
TTGAAGTGTGG -> TGAAGTGTGGA
TTGAATAGAGC -> TGAATAGAGCG
TTGAATCGTTA -> TGAATCGTTAT
TTGAGCTAGGG -> TGAGCTAGGGG
TTGATACCAGC -> TGATACCAGCG
TTGATTTATCA -> TGATTTATCAG
TTGCACAACGG -> TGCACAACGGA
TTGCCAAAGCT -> TGCCAAAGCTC
TTGCCGGACGA -> TGCCGGACGAT
TTGCCTCTATG -> TGCCTCTATGA
TTGCGGCGTGG -> TGCGGCGTGGT
TTGCTTGCCAA -> TGCTTGCCAAA
TTGGAATTCAA -> TGGAATTCAAG
TTGGAGCCCTC -> TGGAGCCCTCG
TTGGCCGTTGA -> TGGCCGTTGAA
TTGGCGCTTCC -> TGGCGCTTCCG
TTGGTAGCGCG -> TGGTAGCGCGA
TTGGTCTTGGT -> TGGTCTTGGTT
TTGGTTCAAAC -> TGGTTCAAACT
TTGTAACTATG -> TGTAACTATGT
TTGTACTACCC -> TGTACTACCCG
TTGTATCTGAG -> TGTATCTGAGG
TTGTCGCATTC -> TGTCGCATTCG
TTGTGCATTGT -> TGTGCATTGTT
TTGTGTGTCGT -> TGTGTGTCGTC
TTGTGTTTGCA -> TGTGTTTGCAC
TTGTTCTTCAG -> TGTTCTTCAGT
TTGTTGCCGGA -> TGTTGCCGGAC
TTTAAAACAGC -> TTAAAACAGCA
TTTAACCTCGA -> TTAACCTCGAT
TTTAATCTAGA -> TTAATCTAGAC
TTTACATATAT -> TTACATATATT
TTTAGGAGCAT -> TTAGGAGCATA
TTTAGTGGCAC -> TTAGTGGCACC
TTTATCAGTAT -> TTATCAGTATT
TTTCAAGACTT -> TTCAAGACTTT
TTTCAAGTTAG -> TTCAAGTTAGG
TTTCACCAGAA -> TTCACCAGAAC
TTTCCATCCGG -> TTCCATCCGGT
TTTCGTATCAT -> TTCGTATCATG
TTTCTCTAATC -> TTCTCTAATCG
TTTCTGGCAAC -> TTCTGGCAACT
TTTCTTCCAGG -> TTCTTCCAGGG
TTTGAATAGAG -> TTGAATAGAGC
TTTGAGCTAGG -> TTGAGCTAGGG
TTTGCACAACG -> TTGCACAACGG
TTTGGCCGTTG -> TTGGCCGTTGA
TTTGGTAGCGC -> TTGGTAGCGCG
TTTGTAACTAT -> TTGTAACTATG
TTTGTACTACC -> TTGTACTACCC
TTTGTGCATTG -> TTGTGCATTGT
TTTTAAAACAG -> TTTAAAACAGC
TTTTAATCTAG -> TTTAATCTAGA
TTTTACATATA -> TTTACATATAT
TTTTAGTGGCA -> TTTAGTGGCAC
TTTTCAAGTTA -> TTTCAAGTTAG
TTTTCACCAGA -> TTTCACCAGAA
TTTTGGTAGCG -> TTTGGTAGCGC
TTTTGTACTAC -> TTTGTACTACC
TTTTTAGTGGC -> TTTTAGTGGCA
TTTTTCAAGTT -> TTTTCAAGTTA
TTTTTGGTAGC -> TTTTGGTAGCG
TTTTTGTACTA -> TTTTGTACTAC



======
Execution Time: 0.55999994278 s
Memory Used: 21 MB