AAAACACATAA -> AAACACATAAC
AAAACAGATGG -> AAACAGATGGT
AAAAGACAACC -> AAAGACAACCA
AAAAGCCTAGC -> AAAGCCTAGCG
AAAAGCTACGC -> AAAGCTACGCC
AAAAGCTTTTC -> AAAGCTTTTCG
AAAATAAGAGG -> AAATAAGAGGG
AAACACATAAC -> AACACATAACC
AAACAGATGGT -> AACAGATGGTC
AAACCCCCTGT -> AACCCCCTGTT
AAACCCGTCCG -> AACCCGTCCGG
AAACCGGTATA -> AACCGGTATAT
AAACGCTTTAA -> AACGCTTTAAC
AAACTACTGTC -> AACTACTGTCT
AAACTTATGGC -> AACTTATGGCA
AAAGACAACCA -> AAGACAACCAA
AAAGCCTAGCG -> AAGCCTAGCGC
AAAGCGACGAC -> AAGCGACGACC
AAAGCGTCAGT -> AAGCGTCAGTA
AAAGCTACGCC -> AAGCTACGCCA
AAAGCTCAATC -> AAGCTCAATCA
AAAGCTTTTCG -> AAGCTTTTCGC
AAAGGAATGTG -> AAGGAATGTGA
AAAGTTTTTTT -> AAGTTTTTTTA
AAATAAATGTA -> AATAAATGTAA
AAATAAGAGGG -> AATAAGAGGGT
AAATCGACGTG -> AATCGACGTGG
AAATCTTCTTG -> AATCTTCTTGC
AAATGAAAAGC -> AATGAAAAGCT
AAATGACTATC -> AATGACTATCC
AAATGCCGGCC -> AATGCCGGCCG
AAATGTAATTG -> AATGTAATTGT
AAATTTAGCTA -> AATTTAGCTAG
AACACATAACC -> ACACATAACCT
AACAGATGGTC -> ACAGATGGTCG
AACAGTACACA -> ACAGTACACAA
AACATAATCCC -> ACATAATCCCT
AACATATGACT -> ACATATGACTC
AACATCTTTCA -> ACATCTTTCAC
AACCAAATCTT -> ACCAAATCTTC
AACCAATGCAG -> ACCAATGCAGG
AACCACCAGCA -> ACCACCAGCAC
AACCATAAGAG -> ACCATAAGAGC
AACCCACGGAG -> ACCCACGGAGC
AACCCCCTGTT -> ACCCCCTGTTT
AACCCGCTAAG -> ACCCGCTAAGT
AACCCGTCCGG -> ACCCGTCCGGT
AACCGCGTCGT -> ACCGCGTCGTA
AACCGGTATAT -> ACCGGTATATG
AACCTACCTAC -> ACCTACCTACC
AACCTGGAAGG -> ACCTGGAAGGA
AACCTTCACCA -> ACCTTCACCAC
AACGACACCGC -> ACGACACCGCG
AACGACTACGA -> ACGACTACGAC
AACGCGTAGGA -> ACGCGTAGGAG
AACGCTTTAAC -> ACGCTTTAACA
AACGTAGCCTC -> ACGTAGCCTCT
AACGTGAGGAA -> ACGTGAGGAAC
AACTACTGTCT -> ACTACTGTCTT
AACTCCGTTCG -> ACTCCGTTCGT
AACTGACCCAC -> ACTGACCCACT
AACTGATGCTG -> ACTGATGCTGG
AACTTATGGCA -> ACTTATGGCAT
AACTTTAGTAT -> ACTTTAGTATA
AAGACAACCAA -> AGACAACCAAA
AAGAGCGGATT -> AGAGCGGATTC
AAGAGCTACTG -> AGAGCTACTGC
AAGAGGGTGAG -> AGAGGGTGAGA
AAGAGTCTTTT -> AGAGTCTTTTG
AAGATAGCCCG -> AGATAGCCCGT
AAGATGTTCCT -> AGATGTTCCTC
AAGCAACCTAC -> AGCAACCTACC
AAGCACGATGA -> AGCACGATGAG
AAGCCTAGCGC -> AGCCTAGCGCG
AAGCGACGACC -> AGCGACGACCT
AAGCGGGCACT -> AGCGGGCACTA
AAGCGTCAGTA -> AGCGTCAGTAA
AAGCTACGCCA -> AGCTACGCCAT
AAGCTCAATCA -> AGCTCAATCAA
AAGCTTTTCGC -> AGCTTTTCGCT
AAGGAAATTTA -> AGGAAATTTAG
AAGGAATGTGA -> AGGAATGTGAT
AAGGATTATTC -> AGGATTATTCA
AAGGGCACTTG -> AGGGCACTTGA
AAGGTACCTCC -> AGGTACCTCCT
AAGGTACGGAA -> AGGTACGGAAG
AAGTACGTGGA -> AGTACGTGGAA
AAGTATAAACG -> AGTATAAACGC
AAGTGACACGT -> AGTGACACGTA
AAGTGCTGGAA -> AGTGCTGGAAC
AAGTTTTTTTA -> AGTTTTTTTAA
AATAAATGTAA -> ATAAATGTAAT
AATAACTGACC -> ATAACTGACCC
AATAAGAGGGT -> ATAAGAGGGTG
AATAAGCACGA -> ATAAGCACGAT
AATACAAGAGT -> ATACAAGAGTC
AATACGCGTGA -> ATACGCGTGAC
AATACTCATGT -> ATACTCATGTC
AATAGGCATGT -> ATAGGCATGTT
AATATGTATTT -> ATATGTATTTT
AATCAACCCAC -> ATCAACCCACG
AATCAATGAAA -> ATCAATGAAAC
AATCATTCCAG -> ATCATTCCAGA
AATCCCGCTAC -> ATCCCGCTACA
AATCCCTCAGC -> ATCCCTCAGCA
AATCCGCTTTA -> ATCCGCTTTAT
AATCCGTGGGC -> ATCCGTGGGCC
AATCGAACCCG -> ATCGAACCCGC
AATCGACGTGG -> ATCGACGTGGG
AATCGTCGCTT -> ATCGTCGCTTG
AATCGTTATCT -> ATCGTTATCTC
AATCTACACCG -> ATCTACACCGA
AATCTTCTTGC -> ATCTTCTTGCT
AATGAAAAGCT -> ATGAAAAGCTA
AATGAAACTAC -> ATGAAACTACT
AATGACTATCC -> ATGACTATCCG
AATGCAGGTGA -> ATGCAGGTGAA
AATGCCGAAAC -> ATGCCGAAACT
AATGCCGGCCG -> ATGCCGGCCGG
AATGTAATTGT -> ATGTAATTGTA
AATGTGATATC -> ATGTGATATCC
AATTACAGCAT -> ATTACAGCATA
AATTAGAAGAT -> ATTAGAAGATG
AATTGTATCAT -> ATTGTATCATG
AATTTAGCTAG -> ATTTAGCTAGA
ACAAAAGACAA -> CAAAAGACAAC
ACAAACCCGTC -> CAAACCCGTCC
ACAAAGCGACG -> CAAAGCGACGA
ACAAAGCGTCA -> CAAAGCGTCAG
ACAAATAAATG -> CAAATAAATGT
ACAAATGAAAA -> CAAATGAAAAG
ACAACCAAATC -> CAACCAAATCT
ACAACGTGAGG -> CAACGTGAGGA
ACAAGAGTCTT -> CAAGAGTCTTT
ACACAAATGAA -> CACAAATGAAA
ACACATAACCT -> CACATAACCTG
ACACCGATTGA -> CACCGATTGAA
ACACCGCGTCA -> CACCGCGTCAG
ACACGAATACT -> CACGAATACTC
ACACGTAGTGG -> CACGTAGTGGA
ACACGTGCGAC -> CACGTGCGACA
ACACGTGTGGG -> CACGTGTGGGT
ACAGACTCCGG -> CAGACTCCGGC
ACAGAGAACTC -> CAGAGAACTCC
ACAGATACCTC -> CAGATACCTCG
ACAGATGGTCG -> CAGATGGTCGT
ACAGCATATGC -> CAGCATATGCT
ACAGCCCGAGA -> CAGCCCGAGAG
ACAGCTAGGAG -> CAGCTAGGAGA
ACAGGCGCAAC -> CAGGCGCAACA
ACAGTACACAA -> CAGTACACAAA
ACATAACCTGG -> CATAACCTGGA
ACATAATCCCT -> CATAATCCCTC
ACATATGACTC -> CATATGACTCA
ACATCTTTCAC -> CATCTTTCACA
ACATGACAAAG -> CATGACAAAGC
ACATGGGCGCA -> CATGGGCGCAA
ACATTCCCAGC -> CATTCCCAGCA
ACATTGGGTTA -> CATTGGGTTAG
ACCAAATCTTC -> CCAAATCTTCT
ACCAACATCTT -> CCAACATCTTT
ACCAATCGAAC -> CCAATCGAACC
ACCAATGCAGG -> CCAATGCAGGT
ACCACAGCCCG -> CCACAGCCCGA
ACCACCAGCAC -> CCACCAGCACT
ACCAGAGGTCT -> CCAGAGGTCTA
ACCAGCACTAC -> CCAGCACTACT
ACCATAAGAGC -> CCATAAGAGCT
ACCCACGGAGC -> CCCACGGAGCG
ACCCACTGCAC -> CCCACTGCACA
ACCCATGGTTT -> CCCATGGTTTC
ACCCCCTGTTT -> CCCCCTGTTTG
ACCCGCCGCAG -> CCCGCCGCAGC
ACCCGCTAAGT -> CCCGCTAAGTG
ACCCGTCCGGT -> CCCGTCCGGTA
ACCGATTGAAT -> CCGATTGAATA
ACCGCGTCAGC -> CCGCGTCAGCT
ACCGCGTCGTA -> CCGCGTCGTAC
ACCGGTATATG -> CCGGTATATGT
ACCTACCTACC -> CCTACCTACCT
ACCTACCTTGG -> CCTACCTTGGA
ACCTCCGGGGC -> CCTCCGGGGCC
ACCTCCTCCTC -> CCTCCTCCTCC
ACCTCGCTGTC -> CCTCGCTGTCC
ACCTCTAATTA -> CCTCTAATTAG
ACCTCTAGAAC -> CCTCTAGAACG
ACCTCTGACGT -> CCTCTGACGTG
ACCTGACAAAT -> CCTGACAAATA
ACCTGCTCAGA -> CCTGCTCAGAA
ACCTGGAAGGA -> CCTGGAAGGAT
ACCTGGGCGCA -> CCTGGGCGCAC
ACCTTACGTCG -> CCTTACGTCGT
ACCTTCACCAC -> CCTTCACCACA
ACCTTGGAGCC -> CCTTGGAGCCT
ACGAATACTCA -> CGAATACTCAT
ACGACACCGCG -> CGACACCGCGT
ACGACCTCTAG -> CGACCTCTAGA
ACGACTACGAC -> CGACTACGACT
ACGACTTCTCC -> CGACTTCTCCA
ACGAGGTACGG -> CGAGGTACGGA
ACGATATAGGA -> CGATATAGGAA
ACGATGAGTAC -> CGATGAGTACG
ACGCAGTTTTG -> CGCAGTTTTGT
ACGCCATCCAC -> CGCCATCCACG
ACGCGTAGGAG -> CGCGTAGGAGT
ACGCGTGACAA -> CGCGTGACAAA
ACGCTATAGCC -> CGCTATAGCCA
ACGCTGTTTGT -> CGCTGTTTGTG
ACGCTTTAACA -> CGCTTTAACAG
ACGGAAGCAAC -> CGGAAGCAACC
ACGGAAGTACG -> CGGAAGTACGT
ACGGAGCGACT -> CGGAGCGACTG
ACGGAGGCAGG -> CGGAGGCAGGA
ACGGATTAATC -> CGGATTAATCC
ACGGGAGAGCG -> CGGGAGAGCGT
ACGTACCTGAC -> CGTACCTGACA
ACGTAGCCTCT -> CGTAGCCTCTG
ACGTAGTGGAC -> CGTAGTGGACC
ACGTCGTGTAC -> CGTCGTGTACT
ACGTGACTAGC -> CGTGACTAGCG
ACGTGAGGAAC -> CGTGAGGAACC
ACGTGCGACAG -> CGTGCGACAGA
ACGTGGAAAAC -> CGTGGAAAACA
ACGTGGGGTAT -> CGTGGGGTATT
ACGTGTGGGTG -> CGTGTGGGTGA
ACTAACCATAA -> CTAACCATAAG
ACTACGACTTC -> CTACGACTTCT
ACTACTGTCTT -> CTACTGTCTTG
ACTACTTCTTT -> CTACTTCTTTT
ACTAGATAAAT -> CTAGATAAATG
ACTAGCCCGCT -> CTAGCCCGCTA
ACTAGCGCGGT -> CTAGCGCGGTG
ACTATCCGTGT -> CTATCCGTGTG
ACTATGTCTGG -> CTATGTCTGGC
ACTCACGTACC -> CTCACGTACCT
ACTCATGTCGG -> CTCATGTCGGT
ACTCCGGCGCA -> CTCCGGCGCAG
ACTCCGTTCGT -> CTCCGTTCGTC
ACTCTCCTCAC -> CTCTCCTCACC
ACTCTCGCCCA -> CTCTCGCCCAC
ACTGAATCAAT -> CTGAATCAATG
ACTGACCCACT -> CTGACCCACTG
ACTGATCCTAT -> CTGATCCTATT
ACTGATGCTGG -> CTGATGCTGGA
ACTGCACAGAC -> CTGCACAGACT
ACTGCCTCTTG -> CTGCCTCTTGA
ACTGCGTAAAA -> CTGCGTAAAAG
ACTGGATGCCC -> CTGGATGCCCC
ACTGTCTTGAT -> CTGTCTTGATA
ACTTATGGCAT -> CTTATGGCATT
ACTTCCGTAGG -> CTTCCGTAGGG
ACTTCTCCATC -> CTTCTCCATCT
ACTTCTTTTGC -> CTTCTTTTGCA
ACTTGACTTTA -> CTTGACTTTAC
ACTTTAACGCG -> CTTTAACGCGT
ACTTTACCAAT -> CTTTACCAATC
ACTTTAGTATA -> CTTTAGTATAA
AGAAACCCCCT -> GAAACCCCCTG
AGAAACCGGTA -> GAAACCGGTAT
AGAACGACTAC -> GAACGACTACG
AGAACGTAGCC -> GAACGTAGCCT
AGAACTCCGTT -> GAACTCCGTTC
AGAACTGATGC -> GAACTGATGCT
AGAAGAGCGGA -> GAAGAGCGGAT
AGAAGATGTTC -> GAAGATGTTCC
AGAAGCGGGCA -> GAAGCGGGCAC
AGACAACCAAA -> GACAACCAAAT
AGACATGGGCG -> GACATGGGCGC
AGACCCGCCGC -> GACCCGCCGCA
AGACTCCGGCG -> GACTCCGGCGC
AGAGAACTCCG -> GAGAACTCCGT
AGAGAACTGAT -> GAGAACTGATG
AGAGACATGGG -> GAGACATGGGC
AGAGCGGATTC -> GAGCGGATTCC
AGAGCGTCCTA -> GAGCGTCCTAT
AGAGCTACTGC -> GAGCTACTGCC
AGAGGGCGCGT -> GAGGGCGCGTC
AGAGGGTGAGA -> GAGGGTGAGAC
AGAGGTCTACG -> GAGGTCTACGA
AGAGTCTTTTG -> GAGTCTTTTGT
AGATAAATGAC -> GATAAATGACT
AGATACCTCGC -> GATACCTCGCT
AGATACGCAGT -> GATACGCAGTT
AGATAGCCCGT -> GATAGCCCGTC
AGATGGTCGTA -> GATGGTCGTAG
AGATGTTCCTC -> GATGTTCCTCA
AGATTCCGTGG -> GATTCCGTGGT
AGCAAAGTTTT -> GCAAAGTTTTT
AGCAACCTACC -> GCAACCTACCT
AGCAATACGCG -> GCAATACGCGT
AGCACAGGCGC -> GCACAGGCGCA
AGCACGATGAG -> GCACGATGAGT
AGCACTACTTC -> GCACTACTTCT
AGCATATGCTT -> GCATATGCTTT
AGCCACGCTGT -> GCCACGCTGTT
AGCCCGAGAGG -> GCCCGAGAGGG
AGCCCGCTAGT -> GCCCGCTAGTA
AGCCCGTCCCC -> GCCCGTCCCCT
AGCCCGTTTAT -> GCCCGTTTATG
AGCCTAGCGCG -> GCCTAGCGCGC
AGCCTCCGAAA -> GCCTCCGAAAT
AGCCTCTGATG -> GCCTCTGATGA
AGCGACGACCT -> GCGACGACCTC
AGCGACTGATC -> GCGACTGATCC
AGCGCGCTCAA -> GCGCGCTCAAT
AGCGCGGTGTA -> GCGCGGTGTAT
AGCGGATTCCT -> GCGGATTCCTA
AGCGGGCACTA -> GCGGGCACTAG
AGCGTCAGTAA -> GCGTCAGTAAT
AGCGTCCTATC -> GCGTCCTATCC
AGCTACGCCAT -> GCTACGCCATC
AGCTACTGCCT -> GCTACTGCCTC
AGCTAGAAGAG -> GCTAGAAGAGC
AGCTAGGAGAG -> GCTAGGAGAGA
AGCTATGGACA -> GCTATGGACAC
AGCTCAATCAA -> GCTCAATCAAC
AGCTGGGAGTT -> GCTGGGAGTTC
AGCTTGTTCCT -> GCTTGTTCCTA
AGCTTTTCGCT -> GCTTTTCGCTA
AGGAAATGCCG -> GGAAATGCCGG
AGGAAATTTAG -> GGAAATTTAGC
AGGAACCACCA -> GGAACCACCAG
AGGAACCTTCA -> GGAACCTTCAC
AGGAATGTGAT -> GGAATGTGATA
AGGAGAGACAT -> GGAGAGACATG
AGGAGTTGGTA -> GGAGTTGGTAC
AGGATAAACGA -> GGATAAACGAG
AGGATTATTCA -> GGATTATTCAT
AGGCAGGAACC -> GGCAGGAACCA
AGGCATGTTTT -> GGCATGTTTTA
AGGCCCCTAAG -> GGCCCCTAAGG
AGGCGCAACAT -> GGCGCAACATA
AGGCTTCACCT -> GGCTTCACCTG
AGGGATCGAAT -> GGGATCGAATC
AGGGCACTTGA -> GGGCACTTGAC
AGGGCCACAAA -> GGGCCACAAAG
AGGGCGCGTCA -> GGGCGCGTCAG
AGGGTATCAGA -> GGGTATCAGAG
AGGGTGAGACC -> GGGTGAGACCC
AGGTACACGTG -> GGTACACGTGC
AGGTACCTCCT -> GGTACCTCCTC
AGGTACGGAAG -> GGTACGGAAGC,GGTACGGAAGT
AGGTCTACGAG -> GGTCTACGAGG
AGGTGAACCGC -> GGTGAACCGCG
AGGTGCCATCA -> GGTGCCATCAG
AGTAATTACAG -> GTAATTACAGC
AGTACACAAAT -> GTACACAAATG
AGTACAGCTAG -> GTACAGCTAGG
AGTACGCTATA -> GTACGCTATAG
AGTACGTGGAA -> GTACGTGGAAA
AGTACTATGTC -> GTACTATGTCT
AGTAGGCCCCT -> GTAGGCCCCTA
AGTATAAACGC -> GTATAAACGCT
AGTATAAAGGA -> GTATAAAGGAA
AGTCAGGTGCC -> GTCAGGTGCCA
AGTCTCTACTC -> GTCTCTACTCT
AGTCTTTTGTT -> GTCTTTTGTTT
AGTGACACGTA -> GTGACACGTAG
AGTGCTAGGGT -> GTGCTAGGGTA
AGTGCTGGAAC -> GTGCTGGAACC
AGTGGACCTCT -> GTGGACCTCTG
AGTTCATGACA -> GTTCATGACAT
AGTTCTTGGCC -> GTTCTTGGCCT
AGTTGGTACGG -> GTTGGTACGGG
AGTTTTGTTCG -> GTTTTGTTCGA
AGTTTTTTTAA -> GTTTTTTTAAT
ATAAACGCTTT -> TAAACGCTTTA
ATAAAGGAATG -> TAAAGGAATGT
ATAAATGACTA -> TAAATGACTAT
ATAAATGTAAT -> TAAATGTAATT
ATAACCTGGAA -> TAACCTGGAAG
ATAACTGACCC -> TAACTGACCCA
ATAACTTTAGT -> TAACTTTAGTA
ATAAGAGCTAC -> TAAGAGCTACT
ATAAGAGGGTG -> TAAGAGGGTGA
ATAAGCACGAT -> TAAGCACGATG
ATAATCATTCC -> TAATCATTCCA
ATAATCCCTCA -> TAATCCCTCAG
ATACAAGAGTC -> TACAAGAGTCT
ATACCTCGCTG -> TACCTCGCTGT
ATACGCAGTTT -> TACGCAGTTTT
ATACGCGTGAC -> TACGCGTGACA
ATACTCATGTC -> TACTCATGTCG
ATAGCCACGCT -> TAGCCACGCTG
ATAGCCCGTCC -> TAGCCCGTCCC
ATAGGAAATGC -> TAGGAAATGCC
ATAGGCATGTT -> TAGGCATGTTT
ATATAGGAAAT -> TATAGGAAATG
ATATCCTATGT -> TATCCTATGTA
ATATGACTCAC -> TATGACTCACG
ATATGCTTTCG -> TATGCTTTCGC
ATATGTATTTT -> TATGTATTTTC
ATATGTTCCAC -> TATGTTCCACG
ATATTGCAGGA -> TATTGCAGGAT
ATCAACCCACG -> TCAACCCACGG
ATCAATATGTA -> TCAATATGTAT
ATCAATGAAAC -> TCAATGAAACT
ATCAGAAACCG -> TCAGAAACCGG
ATCAGAGAACT -> TCAGAGAACTG
ATCAGGCTTCA -> TCAGGCTTCAC
ATCATGCAACG -> TCATGCAACGA
ATCATTCCAGA -> TCATTCCAGAA
ATCCAAAATAA -> TCCAAAATAAG
ATCCACGGATT -> TCCACGGATTA
ATCCCGCTACA -> TCCCGCTACAC
ATCCCTCAGCA -> TCCCTCAGCAA
ATCCGCTTTAT -> TCCGCTTTATG
ATCCGGATAAT -> TCCGGATAATC
ATCCGTGGGCC -> TCCGTGGGCCC
ATCCGTGTGGT -> TCCGTGTGGTA
ATCCTATGTAT -> TCCTATGTATC
ATCCTATTGTT -> TCCTATTGTTA
ATCGAACCCGC -> TCGAACCCGCT
ATCGAATCGTT -> TCGAATCGTTA
ATCGACGTGGG -> TCGACGTGGGG
ATCGAGATACG -> TCGAGATACGC
ATCGTCGCTTG -> TCGTCGCTTGA
ATCGTTATCTC -> TCGTTATCTCC
ATCTACACCGA -> TCTACACCGAT
ATCTACCTCCG -> TCTACCTCCGG
ATCTCCCTGTC -> TCTCCCTGTCC
ATCTTCTTGCT -> TCTTCTTGCTT
ATCTTTACTCT -> TCTTTACTCTC
ATCTTTCACAA -> TCTTTCACAAA
ATGAAAAGCTA -> TGAAAAGCTAC
ATGAAACTACT -> TGAAACTACTG
ATGACAAAGCG -> TGACAAAGCGA
ATGACATTGGG -> TGACATTGGGT
ATGACCCATGG -> TGACCCATGGT
ATGACTATCCG -> TGACTATCCGT
ATGACTCACGT -> TGACTCACGTA
ATGAGTACGCT -> TGAGTACGCTA
ATGAGTCAGGT -> TGAGTCAGGTG
ATGATTGATCA -> TGATTGATCAA
ATGCAACGACA -> TGCAACGACAC
ATGCAAGTATA -> TGCAAGTATAA
ATGCAGGTGAA -> TGCAGGTGAAC
ATGCCCCCCAC -> TGCCCCCCACC
ATGCCGAAACT -> TGCCGAAACTT
ATGCCGGCCGG -> TGCCGGCCGGC
ATGCGGAGTCT -> TGCGGAGTCTC
ATGCTGGACAA -> TGCTGGACAAC
ATGCTTTCGCA -> TGCTTTCGCAG
ATGGAACATAA -> TGGAACATAAT
ATGGACACGTG -> TGGACACGTGT
ATGGCATTATT -> TGGCATTATTA
ATGGCTTGGTT -> TGGCTTGGTTC
ATGGGCGCAAG -> TGGGCGCAAGG
ATGGTCGTAGC -> TGGTCGTAGCA
ATGGTTTCAGC -> TGGTTTCAGCT
ATGTAATTGTA -> TGTAATTGTAT
ATGTATCTACC -> TGTATCTACCT
ATGTATTTTCT -> TGTATTTTCTC
ATGTCGGTCTC -> TGTCGGTCTCG
ATGTCTGGCTC -> TGTCTGGCTCA
ATGTGACCTTA -> TGTGACCTTAC
ATGTGATATCC -> TGTGATATCCT
ATGTTCCACGG -> TGTTCCACGGA
ATGTTCCTCAC -> TGTTCCTCACT
ATGTTTTAATC -> TGTTTTAATCC
ATTAATCCCGC -> TTAATCCCGCT
ATTACAGCATA -> TTACAGCATAT
ATTAGAAGATG -> TTAGAAGATGT
ATTAGCCCGTT -> TTAGCCCGTTT
ATTATTAGCCC -> TTATTAGCCCG
ATTATTCATGA -> TTATTCATGAG
ATTCATGAGTC -> TTCATGAGTCA
ATTCCAGAAGC -> TTCCAGAAGCG
ATTCCCAGCAC -> TTCCCAGCACA
ATTCCGTGGTA -> TTCCGTGGTAG
ATTCCTAATCG -> TTCCTAATCGT
ATTGAATAAGC -> TTGAATAAGCA
ATTGATCAATA -> TTGATCAATAT
ATTGCAGGATA -> TTGCAGGATAA
ATTGGGTTAGT -> TTGGGTTAGTG
ATTGTATCATG -> TTGTATCATGC
ATTGTTAGTAG -> TTGTTAGTAGG
ATTTACGATAT -> TTTACGATATA
ATTTAGCTAGA -> TTTAGCTAGAA
ATTTCTTTAAA -> TTTCTTTAAAA
ATTTGGAATCT -> TTTGGAATCTA
ATTTTCTCCAC -> TTTTCTCCACT
CAAAAGACAAC -> AAAAGACAACC
CAAAAGCTTTT -> AAAAGCTTTTC
CAAAATAAGAG -> AAAATAAGAGG
CAAACCCGTCC -> AAACCCGTCCG
CAAAGCGACGA -> AAAGCGACGAC
CAAAGCGTCAG -> AAAGCGTCAGT
CAAAGTTTTTT -> AAAGTTTTTTT
CAAATAAATGT -> AAATAAATGTA
CAAATCTTCTT -> AAATCTTCTTG
CAAATGAAAAG -> AAATGAAAAGC
CAACATATGAC -> AACATATGACT
CAACATCTTTC -> AACATCTTTCA
CAACCAAATCT -> AACCAAATCTT
CAACCCACGGA -> AACCCACGGAG
CAACCTACCTA -> AACCTACCTAC
CAACGACACCG -> AACGACACCGC
CAACGTGAGGA -> AACGTGAGGAA
CAAGAGTCTTT -> AAGAGTCTTTT
CAAGGAAATTT -> AAGGAAATTTA
CAAGGGCACTT -> AAGGGCACTTG
CAAGTATAAAC -> AAGTATAAACG
CAATACAAGAG -> AATACAAGAGT
CAATACGCGTG -> AATACGCGTGA
CAATATGTATT -> AATATGTATTT
CAATCAACCCA -> AATCAACCCAC
CAATCGAACCC -> AATCGAACCCG
CAATGAAACTA -> AATGAAACTAC
CAATGCAGGTG -> AATGCAGGTGA
CACAAAAGACA -> ACAAAAGACAA
CACAAAGCGTC -> ACAAAGCGTCA
CACAAATGAAA -> ACAAATGAAAA
CACAGACTCCG -> ACAGACTCCGG
CACAGATACCT -> ACAGATACCTC
CACAGCCCGAG -> ACAGCCCGAGA
CACAGGCGCAA -> ACAGGCGCAAC
CACATAACCTG -> ACATAACCTGG
CACATTCCCAG -> ACATTCCCAGC
CACCAACATCT -> ACCAACATCTT
CACCACAGCCC -> ACCACAGCCCG
CACCAGAGGTC -> ACCAGAGGTCT
CACCAGCACTA -> ACCAGCACTAC
CACCGATTGAA -> ACCGATTGAAT
CACCGCGTCAG -> ACCGCGTCAGC
CACCTCTAATT -> ACCTCTAATTA
CACCTGCTCAG -> ACCTGCTCAGA
CACCTGGGCGC -> ACCTGGGCGCA
CACGAATACTC -> ACGAATACTCA
CACGATGAGTA -> ACGATGAGTAC
CACGCTGTTTG -> ACGCTGTTTGT
CACGGAGCGAC -> ACGGAGCGACT
CACGGAGGCAG -> ACGGAGGCAGG
CACGGATTAAT -> ACGGATTAATC
CACGTACCTGA -> ACGTACCTGAC
CACGTAGTGGA -> ACGTAGTGGAC
CACGTGCGACA -> ACGTGCGACAG
CACGTGTGGGT -> ACGTGTGGGTG
CACTACTTCTT -> ACTACTTCTTT
CACTAGATAAA -> ACTAGATAAAT
CACTAGCCCGC -> ACTAGCCCGCT
CACTGCACAGA -> ACTGCACAGAC
CACTGCGTAAA -> ACTGCGTAAAA
CACTTGACTTT -> ACTTGACTTTA
CAGAAACCCCC -> AGAAACCCCCT
CAGAAACCGGT -> AGAAACCGGTA
CAGAACGACTA -> AGAACGACTAC
CAGAAGCGGGC -> AGAAGCGGGCA
CAGACTCCGGC -> AGACTCCGGCG
CAGAGAACTCC -> AGAGAACTCCG
CAGAGAACTGA -> AGAGAACTGAT
CAGAGGTCTAC -> AGAGGTCTACG
CAGATACCTCG -> AGATACCTCGC
CAGATGGTCGT -> AGATGGTCGTA
CAGATTCCGTG -> AGATTCCGTGG
CAGCAAAGTTT -> AGCAAAGTTTT
CAGCACAGGCG -> AGCACAGGCGC
CAGCACTACTT -> AGCACTACTTC
CAGCATATGCT -> AGCATATGCTT
CAGCCCGAGAG -> AGCCCGAGAGG
CAGCTAGGAGA -> AGCTAGGAGAG
CAGCTATGGAC -> AGCTATGGACA
CAGCTGGGAGT -> AGCTGGGAGTT
CAGCTTGTTCC -> AGCTTGTTCCT
CAGGAACCACC -> AGGAACCACCA
CAGGATAAACG -> AGGATAAACGA
CAGGCGCAACA -> AGGCGCAACAT
CAGGCTTCACC -> AGGCTTCACCT
CAGGGCCACAA -> AGGGCCACAAA
CAGGTGAACCG -> AGGTGAACCGC
CAGGTGCCATC -> AGGTGCCATCA
CAGTAATTACA -> AGTAATTACAG
CAGTACACAAA -> AGTACACAAAT
CAGTACAGCTA -> AGTACAGCTAG
CAGTTTTGTTC -> AGTTTTGTTCG
CATAACCTGGA -> ATAACCTGGAA
CATAAGAGCTA -> ATAAGAGCTAC
CATAATCCCTC -> ATAATCCCTCA
CATATGACTCA -> ATATGACTCAC
CATATGCTTTC -> ATATGCTTTCG
CATCAGAAACC -> ATCAGAAACCG
CATCAGGCTTC -> ATCAGGCTTCA
CATCCAAAATA -> ATCCAAAATAA
CATCCACGGAT -> ATCCACGGATT
CATCTTTACTC -> ATCTTTACTCT
CATCTTTCACA -> ATCTTTCACAA
CATGACAAAGC -> ATGACAAAGCG
CATGACATTGG -> ATGACATTGGG
CATGAGTCAGG -> ATGAGTCAGGT
CATGCAACGAC -> ATGCAACGACA
CATGGCTTGGT -> ATGGCTTGGTT
CATGGGCGCAA -> ATGGGCGCAAG
CATGGTTTCAG -> ATGGTTTCAGC
CATGTCGGTCT -> ATGTCGGTCTC
CATGTTTTAAT -> ATGTTTTAATC
CATTATTAGCC -> ATTATTAGCCC
CATTCCAGAAG -> ATTCCAGAAGC
CATTCCCAGCA -> ATTCCCAGCAC
CATTGGGTTAG -> ATTGGGTTAGT
CCAAAATAAGA -> CAAAATAAGAG
CCAAATCTTCT -> CAAATCTTCTT
CCAACATCTTT -> CAACATCTTTC
CCAATCGAACC -> CAATCGAACCC
CCAATGCAGGT -> CAATGCAGGTG
CCACAAAGCGT -> CACAAAGCGTC
CCACAGCCCGA -> CACAGCCCGAG
CCACATTCCCA -> CACATTCCCAG
CCACCAGCACT -> CACCAGCACTA
CCACCTGGGCG -> CACCTGGGCGC
CCACGCTGTTT -> CACGCTGTTTG
CCACGGAGCGA -> CACGGAGCGAC
CCACGGAGGCA -> CACGGAGGCAG
CCACGGATTAA -> CACGGATTAAT
CCACTGCACAG -> CACTGCACAGA
CCACTGCGTAA -> CACTGCGTAAA
CCAGAAGCGGG -> CAGAAGCGGGC
CCAGAGGTCTA -> CAGAGGTCTAC
CCAGCACAGGC -> CAGCACAGGCG
CCAGCACTACT -> CAGCACTACTT
CCATAAGAGCT -> CATAAGAGCTA
CCATCAGAAAC -> CATCAGAAACC
CCATCCACGGA -> CATCCACGGAT
CCATCTTTACT -> CATCTTTACTC
CCATGGTTTCA -> CATGGTTTCAG
CCCACATTCCC -> CCACATTCCCA
CCCACCTGGGC -> CCACCTGGGCG
CCCACGGAGCG -> CCACGGAGCGA
CCCACTGCACA -> CCACTGCACAG
CCCAGCACAGG -> CCAGCACAGGC
CCCATGGTTTC -> CCATGGTTTCA
CCCCACCTGGG -> CCCACCTGGGC
CCCCCACCTGG -> CCCCACCTGGG
CCCCCCACCTG -> CCCCCACCTGG
CCCCCTGTTTG -> CCCCTGTTTGC
CCCCTAAGGTA -> CCCTAAGGTAC
CCCCTCCGAAT -> CCCTCCGAATA
CCCCTGTTTGC -> CCCTGTTTGCA
CCCGAATAACT -> CCGAATAACTG
CCCGAGAGGGC -> CCGAGAGGGCG
CCCGCCGCAGC -> CCGCCGCAGCT
CCCGCTAAGTG -> CCGCTAAGTGC
CCCGCTACACG -> CCGCTACACGA
CCCGCTAGTAC -> CCGCTAGTACT
CCCGTCCCCTC -> CCGTCCCCTCC
CCCGTCCGGTA -> CCGTCCGGTAA
CCCGTTTATGA -> CCGTTTATGAT
CCCTAAGGTAC -> CCTAAGGTACG
CCCTCAGCAAA -> CCTCAGCAAAG
CCCTCCGAATA -> CCTCCGAATAG
CCCTCGATATT -> CCTCGATATTG
CCCTGGATTTC -> CCTGGATTTCT
CCCTGTCCCTG -> CCTGTCCCTGG
CCCTGTTTGCA -> CCTGTTTGCAC
CCGAAACTTAT -> CGAAACTTATG
CCGAAATCGAC -> CGAAATCGACG
CCGAATAACTG -> CGAATAACTGA
CCGAATAGGCA -> CGAATAGGCAT
CCGAGAGGGCG -> CGAGAGGGCGC
CCGATTGAATA -> CGATTGAATAA
CCGCAGCTGGG -> CGCAGCTGGGA
CCGCCGCAGCT -> CGCCGCAGCTG
CCGCGTCAGCT -> CGCGTCAGCTA
CCGCGTCGTAC -> CGCGTCGTACT
CCGCTAAGTGC -> CGCTAAGTGCT
CCGCTACACGA -> CGCTACACGAA
CCGCTAGTACT -> CGCTAGTACTA
CCGCTTTATGC -> CGCTTTATGCA
CCGGATAATCA -> CGGATAATCAT
CCGGCAAGGAA -> CGGCAAGGAAA
CCGGCCGGCAA -> CGGCCGGCAAG
CCGGCGCAGAT -> CGGCGCAGATT
CCGGGGCCCTC -> CGGGGCCCTCG
CCGGTAATCCG -> CGGTAATCCGC
CCGGTATATGT -> CGGTATATGTT
CCGTAGGGATC -> CGTAGGGATCG
CCGTCCCCTCC -> CGTCCCCTCCG
CCGTCCGGTAA -> CGTCCGGTAAT
CCGTGGGCCCG -> CGTGGGCCCGA
CCGTGGTAGTT -> CGTGGTAGTTC
CCGTGTGGTAA -> CGTGTGGTAAA
CCGTTCGTCTG -> CGTTCGTCTGG
CCGTTTATGAT -> CGTTTATGATT
CCTAAGGTACG -> CTAAGGTACGG
CCTAATCGTCG -> CTAATCGTCGC
CCTACCTACCT -> CTACCTACCTT
CCTACCTTGGA -> CTACCTTGGAG
CCTAGCGCGCT -> CTAGCGCGCTC
CCTATCCGGAT -> CTATCCGGATA
CCTATGTATCT -> CTATGTATCTA
CCTATTGTTAG -> CTATTGTTAGT
CCTATTTACGA -> CTATTTACGAT
CCTCACCAACA -> CTCACCAACAT
CCTCACTAGAT -> CTCACTAGATA
CCTCAGCAAAG -> CTCAGCAAAGT
CCTCATCCAAA -> CTCATCCAAAA
CCTCCGAAATC -> CTCCGAAATCG
CCTCCGAATAG -> CTCCGAATAGG
CCTCCGGGGCC -> CTCCGGGGCCC
CCTCCTCCTCC -> CTCCTCCTCCT
CCTCCTCCTTG -> CTCCTCCTTGC
CCTCCTTGCTC -> CTCCTTGCTCG
CCTCGATATTG -> CTCGATATTGC
CCTCGCTGTCC -> CTCGCTGTCCT
CCTCTAATTAG -> CTCTAATTAGA
CCTCTAGAACG -> CTCTAGAACGT
CCTCTGACGTG -> CTCTGACGTGA
CCTCTGATGAC -> CTCTGATGACC
CCTCTTACTAA -> CTCTTACTAAC
CCTCTTGATCG -> CTCTTGATCGA
CCTGACAAATA -> CTGACAAATAA
CCTGCTCAGAA -> CTGCTCAGAAA
CCTGGAAGGAT -> CTGGAAGGATT
CCTGGATTTCT -> CTGGATTTCTT
CCTGGGCGCAC -> CTGGGCGCACC
CCTGTCCCTGG -> CTGTCCCTGGA
CCTGTTTGCAC -> CTGTTTGCACA
CCTTACGTCGT -> CTTACGTCGTG
CCTTCACCACA -> CTTCACCACAG
CCTTGCTCGAC -> CTTGCTCGACT
CCTTGGAGCCT -> CTTGGAGCCTC
CGAAACTTATG -> GAAACTTATGG
CGAAATCGACG -> GAAATCGACGT
CGAACCCGCTA -> GAACCCGCTAA
CGAAGATAGCC -> GAAGATAGCCC
CGAAGTGACAC -> GAAGTGACACG
CGAATAACTGA -> GAATAACTGAC
CGAATACTCAT -> GAATACTCATG
CGAATAGGCAT -> GAATAGGCATG
CGAATCGTTAT -> GAATCGTTATC
CGACACCGCGT -> GACACCGCGTC
CGACAGAGAAC -> GACAGAGAACT
CGACCTCTAGA -> GACCTCTAGAA
CGACGACCTCT -> GACGACCTCTA
CGACGTGGGGT -> GACGTGGGGTA
CGACTACGACT -> GACTACGACTT
CGACTGATCCT -> GACTGATCCTA
CGACTTCCGTA -> GACTTCCGTAG
CGACTTCTCCA -> GACTTCTCCAT
CGACTTTAACG -> GACTTTAACGC
CGAGAGGGCGC -> GAGAGGGCGCG
CGAGATACGCA -> GAGATACGCAG
CGAGGTACGGA -> GAGGTACGGAA
CGATATAGGAA -> GATATAGGAAA
CGATATTGCAG -> GATATTGCAGG
CGATGAGTACG -> GATGAGTACGC
CGATTGAATAA -> GATTGAATAAG
CGCAACATATG -> GCAACATATGA
CGCAAGGGCAC -> GCAAGGGCACT
CGCACCTCTAA -> GCACCTCTAAT
CGCAGATTCCG -> GCAGATTCCGT
CGCAGCTGGGA -> GCAGCTGGGAG
CGCAGTACAGC -> GCAGTACAGCT
CGCAGTTTTGT -> GCAGTTTTGTT
CGCCATCCACG -> GCCATCCACGG
CGCCCACATTC -> GCCCACATTCC
CGCCGCAGCTG -> GCCGCAGCTGG
CGCGCTCAATA -> GCGCTCAATAC
CGCGGTGTATG -> GCGGTGTATGT
CGCGTAGGAGT -> GCGTAGGAGTT
CGCGTCAGCTA -> GCGTCAGCTAT
CGCGTCAGGGC -> GCGTCAGGGCC
CGCGTCGTACT -> GCGTCGTACTG
CGCGTGACAAA -> GCGTGACAAAC
CGCTAAGTGCT -> GCTAAGTGCTG
CGCTACACGAA -> GCTACACGAAT
CGCTAGTACTA -> GCTAGTACTAT
CGCTATAGCCA -> GCTATAGCCAC
CGCTATGCGGA -> GCTATGCGGAG
CGCTCAATACA -> GCTCAATACAA
CGCTGTCCTCA -> GCTGTCCTCAT
CGCTGTTTGTG -> GCTGTTTGTGA
CGCTTGAGGTA -> GCTTGAGGTAC
CGCTTTAACAG -> GCTTTAACAGT
CGCTTTATGCA -> GCTTTATGCAA
CGGAAGCAACC -> GGAAGCAACCT
CGGAAGTACGT -> GGAAGTACGTG
CGGAGCGACTG -> GGAGCGACTGA
CGGAGGCAGGA -> GGAGGCAGGAA
CGGAGTCTCTA -> GGAGTCTCTAC
CGGATAATCAT -> GGATAATCATT
CGGATTAATCC -> GGATTAATCCC
CGGATTCCTAA -> GGATTCCTAAT
CGGCAAGGAAA -> GGCAAGGAAAT
CGGCCGGCAAG -> GGCCGGCAAGG
CGGCGCAGATT -> GGCGCAGATTC
CGGGAGAGCGT -> GGGAGAGCGTC
CGGGCACTAGC -> GGGCACTAGCC
CGGGGCCCTCG -> GGGGCCCTCGA
CGGTAATCCGC -> GGTAATCCGCT
CGGTATATGTT -> GGTATATGTTC
CGGTCTCGACT -> GGTCTCGACTT
CGGTGTATGTG -> GGTGTATGTGA
CGTAAAAGCCT -> GTAAAAGCCTA
CGTACCTGACA -> GTACCTGACAA
CGTACTGAATC -> GTACTGAATCA
CGTAGCAATAC -> GTAGCAATACG
CGTAGCCTCTG -> GTAGCCTCTGA
CGTAGGAGTTG -> GTAGGAGTTGG
CGTAGGGATCG -> GTAGGGATCGA
CGTAGTGGACC -> GTAGTGGACCT
CGTCAGCTATG -> GTCAGCTATGG
CGTCAGGGCCA -> GTCAGGGCCAC
CGTCAGTAATT -> GTCAGTAATTA
CGTCCCCTCCG -> GTCCCCTCCGA
CGTCCGGTAAT -> GTCCGGTAATC
CGTCCTATCCG -> GTCCTATCCGG
CGTCGCTTGAG -> GTCGCTTGAGG
CGTCGTACTGA -> GTCGTACTGAA
CGTCGTGTACT -> GTCGTGTACTG
CGTCTGGTCAA -> GTCTGGTCAAA
CGTGACAAACC -> GTGACAAACCC
CGTGACTAGCG -> GTGACTAGCGC
CGTGAGGAACC -> GTGAGGAACCT
CGTGCGACAGA -> GTGCGACAGAG
CGTGGAAAACA -> GTGGAAAACAG
CGTGGGCCCGA -> GTGGGCCCGAA
CGTGGGGTATT -> GTGGGGTATTT
CGTGGTAGTTC -> GTGGTAGTTCA
CGTGTACTGGA -> GTGTACTGGAT
CGTGTGGGTGA -> GTGTGGGTGAA
CGTGTGGTAAA -> GTGTGGTAAAG
CGTTATCTCCC -> GTTATCTCCCT
CGTTCGTCTGG -> GTTCGTCTGGT
CGTTTATGATT -> GTTTATGATTG
CTAACCATAAG -> TAACCATAAGA
CTAAGGTACGG -> TAAGGTACGGA
CTAAGTGCTGG -> TAAGTGCTGGA
CTAATCGTCGC -> TAATCGTCGCT
CTAATTAGAAG -> TAATTAGAAGA
CTACACCGATT -> TACACCGATTG
CTACACGAATA -> TACACGAATAC
CTACCTACCTT -> TACCTACCTTG
CTACCTCCGGG -> TACCTCCGGGG
CTACCTTGGAG -> TACCTTGGAGC
CTACGACTTCT -> TACGACTTCTC
CTACGAGGTAC -> TACGAGGTACG
CTACGCCATCC -> TACGCCATCCA
CTACTCTCCTC -> TACTCTCCTCA
CTACTGCCTCT -> TACTGCCTCTT
CTACTGTCTTG -> TACTGTCTTGA
CTACTTCTTTT -> TACTTCTTTTG
CTAGAACGTAG -> TAGAACGTAGC
CTAGAAGAGCG -> TAGAAGAGCGG
CTAGATAAATG -> TAGATAAATGA
CTAGCCCGCTA -> TAGCCCGCTAG
CTAGCGCGCTC -> TAGCGCGCTCA
CTAGCGCGGTG -> TAGCGCGGTGT
CTAGGAGAGAC -> TAGGAGAGACA
CTAGGGTATCA -> TAGGGTATCAG
CTAGTACTATG -> TAGTACTATGT
CTATAGCCACG -> TATAGCCACGC
CTATCCGGATA -> TATCCGGATAA
CTATCCGTGTG -> TATCCGTGTGG
CTATGCGGAGT -> TATGCGGAGTC
CTATGGACACG -> TATGGACACGT
CTATGTATCTA -> TATGTATCTAC
CTATGTCTGGC -> TATGTCTGGCT
CTATTGTTAGT -> TATTGTTAGTA
CTATTTACGAT -> TATTTACGATA
CTCAATACAAG -> TCAATACAAGA
CTCAATCAACC -> TCAATCAACCC
CTCACCAACAT -> TCACCAACATC
CTCACGTACCT -> TCACGTACCTG
CTCACTAGATA -> TCACTAGATAA
CTCAGAAACCC -> TCAGAAACCCC
CTCAGCAAAGT -> TCAGCAAAGTT
CTCATCCAAAA -> TCATCCAAAAT
CTCATGGCTTG -> TCATGGCTTGG
CTCATGTCGGT -> TCATGTCGGTC
CTCCACTGCGT -> TCCACTGCGTA
CTCCATCTTTA -> TCCATCTTTAC
CTCCCTGTCCC -> TCCCTGTCCCT
CTCCGAAATCG -> TCCGAAATCGA
CTCCGAATAGG -> TCCGAATAGGC
CTCCGGCGCAG -> TCCGGCGCAGA
CTCCGGGGCCC -> TCCGGGGCCCT
CTCCGTTCGTC -> TCCGTTCGTCT
CTCCTCACCAA -> TCCTCACCAAC
CTCCTCCTCCT -> TCCTCCTCCTT
CTCCTCCTTGC -> TCCTCCTTGCT
CTCCTTGCTCG -> TCCTTGCTCGA
CTCGACTTCCG -> TCGACTTCCGT
CTCGACTTTAA -> TCGACTTTAAC
CTCGATATTGC -> TCGATATTGCA
CTCGCCCACAT -> TCGCCCACATT
CTCGCTGTCCT -> TCGCTGTCCTC
CTCTAATTAGA -> TCTAATTAGAA
CTCTACTCTCC -> TCTACTCTCCT
CTCTAGAACGT -> TCTAGAACGTA
CTCTCCTCACC -> TCTCCTCACCA
CTCTCGCCCAC -> TCTCGCCCACA
CTCTGACGTGA -> TCTGACGTGAC
CTCTGATGACC -> TCTGATGACCC
CTCTTACTAAC -> TCTTACTAACC
CTCTTGATCGA -> TCTTGATCGAG
CTGAATCAATG -> TGAATCAATGA
CTGACAAATAA -> TGACAAATAAA
CTGACCCACTG -> TGACCCACTGC
CTGACGTGACT -> TGACGTGACTA
CTGATCCTATT -> TGATCCTATTG
CTGATGACCCA -> TGATGACCCAT
CTGATGCTGGA -> TGATGCTGGAC
CTGCACAGACT -> TGCACAGACTC
CTGCCTCTTGA -> TGCCTCTTGAT
CTGCGTAAAAG -> TGCGTAAAAGC
CTGCTCAGAAA -> TGCTCAGAAAC
CTGGAACCAAT -> TGGAACCAATG
CTGGAAGGATT -> TGGAAGGATTA
CTGGACAACGT -> TGGACAACGTG
CTGGATGCCCC -> TGGATGCCCCC
CTGGATTTCTT -> TGGATTTCTTT
CTGGCTCATGG -> TGGCTCATGGC
CTGGGAGTTCT -> TGGGAGTTCTT
CTGGGCGCACC -> TGGGCGCACCT
CTGGTCAAAAG -> TGGTCAAAAGC
CTGTCCCTGGA -> TGTCCCTGGAT
CTGTCCTCATC -> TGTCCTCATCC
CTGTCTTGATA -> TGTCTTGATAA
CTGTTTGCACA -> TGTTTGCACAG
CTGTTTGTGAC -> TGTTTGTGACA
CTTACGTCGTG -> TTACGTCGTGT
CTTACTAACCA -> TTACTAACCAT
CTTATGGCATT -> TTATGGCATTA
CTTCACCACAG -> TTCACCACAGC
CTTCACCTGCT -> TTCACCTGCTC
CTTCATCAGGC -> TTCATCAGGCT
CTTCCGTAGGG -> TTCCGTAGGGA
CTTCTCCATCT -> TTCTCCATCTT
CTTCTTGCTTG -> TTCTTGCTTGC
CTTCTTTTGCA -> TTCTTTTGCAC
CTTGACTTTAC -> TTGACTTTACC
CTTGAGGTACA -> TTGAGGTACAC
CTTGATAACTT -> TTGATAACTTT
CTTGATCGAGA -> TTGATCGAGAT
CTTGCTCGACT -> TTGCTCGACTT
CTTGCTTCATC -> TTGCTTCATCA
CTTGCTTGCTT -> TTGCTTGCTTC
CTTGGAGCCTC -> TTGGAGCCTCC
CTTGGCCTCTT -> TTGGCCTCTTA
CTTGGTTCGAA -> TTGGTTCGAAG
CTTGTTCCTAT -> TTGTTCCTATT
CTTTAAAACAC -> TTTAAAACACA
CTTTAACAGTA -> TTTAACAGTAC
CTTTAACGCGT -> TTTAACGCGTA
CTTTACCAATC -> TTTACCAATCG
CTTTACTCTCG -> TTTACTCTCGC
CTTTAGTATAA -> TTTAGTATAAA
CTTTATGCAAG -> TTTATGCAAGT
CTTTCACAAAA -> TTTCACAAAAG
CTTTCGCAGTA -> TTTCGCAGTAC
CTTTTCGCTAT -> TTTTCGCTATG
CTTTTGCACCA -> TTTTGCACCAG
CTTTTGTTTTC -> TTTTGTTTTCA
GAAAACAGATG -> AAAACAGATGG
GAAAAGCTACG -> AAAAGCTACGC
GAAACCCCCTG -> AAACCCCCTGT
GAAACCGGTAT -> AAACCGGTATA
GAAACTACTGT -> AAACTACTGTC
GAAACTTATGG -> AAACTTATGGC
GAAATCGACGT -> AAATCGACGTG
GAAATGCCGGC -> AAATGCCGGCC
GAAATTTAGCT -> AAATTTAGCTA
GAACATAATCC -> AACATAATCCC
GAACCAATGCA -> AACCAATGCAG
GAACCACCAGC -> AACCACCAGCA
GAACCCGCTAA -> AACCCGCTAAG
GAACCGCGTCG -> AACCGCGTCGT
GAACCTTCACC -> AACCTTCACCA
GAACGACTACG -> AACGACTACGA
GAACGTAGCCT -> AACGTAGCCTC
GAACTCCGTTC -> AACTCCGTTCG
GAACTGATGCT -> AACTGATGCTG
GAAGAGCGGAT -> AAGAGCGGATT
GAAGATAGCCC -> AAGATAGCCCG
GAAGATGTTCC -> AAGATGTTCCT
GAAGCAACCTA -> AAGCAACCTAC
GAAGCGGGCAC -> AAGCGGGCACT
GAAGGATTATT -> AAGGATTATTC
GAAGGTACCTC -> AAGGTACCTCC
GAAGTACGTGG -> AAGTACGTGGA
GAAGTGACACG -> AAGTGACACGT
GAATAACTGAC -> AATAACTGACC
GAATAAGCACG -> AATAAGCACGA
GAATACTCATG -> AATACTCATGT
GAATAGGCATG -> AATAGGCATGT
GAATCAATGAA -> AATCAATGAAA
GAATCGTTATC -> AATCGTTATCT
GAATCTACACC -> AATCTACACCG
GAATGTGATAT -> AATGTGATATC
GACAAACCCGT -> ACAAACCCGTC
GACAAAGCGAC -> ACAAAGCGACG
GACAAATAAAT -> ACAAATAAATG
GACAACCAAAT -> ACAACCAAATC
GACAACGTGAG -> ACAACGTGAGG
GACACCGCGTC -> ACACCGCGTCA
GACACGTAGTG -> ACACGTAGTGG
GACACGTGTGG -> ACACGTGTGGG
GACAGAGAACT -> ACAGAGAACTC
GACATGACAAA -> ACATGACAAAG
GACATGGGCGC -> ACATGGGCGCA
GACATTGGGTT -> ACATTGGGTTA
GACCCACTGCA -> ACCCACTGCAC
GACCCATGGTT -> ACCCATGGTTT
GACCCGCCGCA -> ACCCGCCGCAG
GACCTCTAGAA -> ACCTCTAGAAC
GACCTCTGACG -> ACCTCTGACGT
GACCTTACGTC -> ACCTTACGTCG
GACGACCTCTA -> ACGACCTCTAG
GACGTGACTAG -> ACGTGACTAGC
GACGTGGGGTA -> ACGTGGGGTAT
GACTACGACTT -> ACTACGACTTC
GACTAGCGCGG -> ACTAGCGCGGT
GACTATCCGTG -> ACTATCCGTGT
GACTCACGTAC -> ACTCACGTACC
GACTCCGGCGC -> ACTCCGGCGCA
GACTGATCCTA -> ACTGATCCTAT
GACTTCCGTAG -> ACTTCCGTAGG
GACTTCTCCAT -> ACTTCTCCATC
GACTTTAACGC -> ACTTTAACGCG
GACTTTACCAA -> ACTTTACCAAT
GAGAACTCCGT -> AGAACTCCGTT
GAGAACTGATG -> AGAACTGATGC
GAGACATGGGC -> AGACATGGGCG
GAGACCCGCCG -> AGACCCGCCGC
GAGAGACATGG -> AGAGACATGGG
GAGAGCGTCCT -> AGAGCGTCCTA
GAGAGGGCGCG -> AGAGGGCGCGT
GAGATACGCAG -> AGATACGCAGT
GAGCCTCCGAA -> AGCCTCCGAAA
GAGCGACTGAT -> AGCGACTGATC
GAGCGGATTCC -> AGCGGATTCCT
GAGCGTCCTAT -> AGCGTCCTATC
GAGCTACTGCC -> AGCTACTGCCT
GAGGAACCTTC -> AGGAACCTTCA
GAGGCAGGAAC -> AGGCAGGAACC
GAGGGCGCGTC -> AGGGCGCGTCA
GAGGGTGAGAC -> AGGGTGAGACC
GAGGTACACGT -> AGGTACACGTG
GAGGTACGGAA -> AGGTACGGAAG
GAGGTCTACGA -> AGGTCTACGAG
GAGTACGCTAT -> AGTACGCTATA
GAGTCAGGTGC -> AGTCAGGTGCC
GAGTCTCTACT -> AGTCTCTACTC
GAGTCTTTTGT -> AGTCTTTTGTT
GAGTTCTTGGC -> AGTTCTTGGCC
GAGTTGGTACG -> AGTTGGTACGG
GATAAATGACT -> ATAAATGACTA
GATAACTTTAG -> ATAACTTTAGT
GATAATCATTC -> ATAATCATTCC
GATACCTCGCT -> ATACCTCGCTG
GATACGCAGTT -> ATACGCAGTTT
GATAGCCCGTC -> ATAGCCCGTCC
GATATAGGAAA -> ATATAGGAAAT
GATATCCTATG -> ATATCCTATGT
GATATTGCAGG -> ATATTGCAGGA
GATCAATATGT -> ATCAATATGTA
GATCCTATTGT -> ATCCTATTGTT
GATCGAATCGT -> ATCGAATCGTT
GATCGAGATAC -> ATCGAGATACG
GATGACCCATG -> ATGACCCATGG
GATGAGTACGC -> ATGAGTACGCT
GATGCCCCCCA -> ATGCCCCCCAC
GATGCTGGACA -> ATGCTGGACAA
GATGGTCGTAG -> ATGGTCGTAGC
GATGTTCCTCA -> ATGTTCCTCAC
GATTAATCCCG -> ATTAATCCCGC
GATTATTCATG -> ATTATTCATGA
GATTCCGTGGT -> ATTCCGTGGTA
GATTCCTAATC -> ATTCCTAATCG
GATTGAATAAG -> ATTGAATAAGC
GATTGATCAAT -> ATTGATCAATA
GATTTCTTTAA -> ATTTCTTTAAA
GCAAAGTTTTT -> CAAAGTTTTTT
GCAACATATGA -> CAACATATGAC
GCAACCTACCT -> CAACCTACCTA
GCAACGACACC -> CAACGACACCG
GCAAGGAAATT -> CAAGGAAATTT
GCAAGGGCACT -> CAAGGGCACTT
GCAAGTATAAA -> CAAGTATAAAC
GCAATACGCGT -> CAATACGCGTG
GCACAGACTCC -> CACAGACTCCG
GCACAGATACC -> CACAGATACCT
GCACAGGCGCA -> CACAGGCGCAA
GCACCAGAGGT -> CACCAGAGGTC
GCACCTCTAAT -> CACCTCTAATT
GCACGATGAGT -> CACGATGAGTA
GCACTACTTCT -> CACTACTTCTT
GCACTAGCCCG -> CACTAGCCCGC
GCACTTGACTT -> CACTTGACTTT
GCAGATTCCGT -> CAGATTCCGTG
GCAGCTGGGAG -> CAGCTGGGAGT
GCAGGAACCAC -> CAGGAACCACC
GCAGGATAAAC -> CAGGATAAACG
GCAGGTGAACC -> CAGGTGAACCG
GCAGTACAGCT -> CAGTACAGCTA
GCAGTTTTGTT -> CAGTTTTGTTC
GCATATGCTTT -> CATATGCTTTC
GCATGTTTTAA -> CATGTTTTAAT
GCATTATTAGC -> CATTATTAGCC
GCCACAAAGCG -> CCACAAAGCGT
GCCACGCTGTT -> CCACGCTGTTT
GCCATCAGAAA -> CCATCAGAAAC
GCCATCCACGG -> CCATCCACGGA
GCCCACATTCC -> CCCACATTCCC
GCCCCCCACCT -> CCCCCCACCTG
GCCCCTAAGGT -> CCCCTAAGGTA
GCCCGAATAAC -> CCCGAATAACT
GCCCGAGAGGG -> CCCGAGAGGGC
GCCCGCTAGTA -> CCCGCTAGTAC
GCCCGTCCCCT -> CCCGTCCCCTC
GCCCGTTTATG -> CCCGTTTATGA
GCCCTCGATAT -> CCCTCGATATT
GCCGAAACTTA -> CCGAAACTTAT
GCCGCAGCTGG -> CCGCAGCTGGG
GCCGGCAAGGA -> CCGGCAAGGAA
GCCGGCCGGCA -> CCGGCCGGCAA
GCCTAGCGCGC -> CCTAGCGCGCT
GCCTCCGAAAT -> CCTCCGAAATC
GCCTCTGATGA -> CCTCTGATGAC
GCCTCTTACTA -> CCTCTTACTAA
GCCTCTTGATC -> CCTCTTGATCG
GCGACAGAGAA -> CGACAGAGAAC
GCGACGACCTC -> CGACGACCTCT
GCGACTGATCC -> CGACTGATCCT
GCGCAACATAT -> CGCAACATATG
GCGCAAGGGCA -> CGCAAGGGCAC
GCGCACCTCTA -> CGCACCTCTAA
GCGCAGATTCC -> CGCAGATTCCG
GCGCGCTCAAT -> CGCGCTCAATA
GCGCGGTGTAT -> CGCGGTGTATG
GCGCGTCAGGG -> CGCGTCAGGGC
GCGCTCAATAC -> CGCTCAATACA
GCGGAGTCTCT -> CGGAGTCTCTA
GCGGATTCCTA -> CGGATTCCTAA
GCGGGCACTAG -> CGGGCACTAGC
GCGGTGTATGT -> CGGTGTATGTG
GCGTAAAAGCC -> CGTAAAAGCCT
GCGTAGGAGTT -> CGTAGGAGTTG
GCGTCAGCTAT -> CGTCAGCTATG
GCGTCAGGGCC -> CGTCAGGGCCA
GCGTCAGTAAT -> CGTCAGTAATT
GCGTCCTATCC -> CGTCCTATCCG
GCGTCGTACTG -> CGTCGTACTGA
GCGTGACAAAC -> CGTGACAAACC
GCTAAGTGCTG -> CTAAGTGCTGG
GCTACACGAAT -> CTACACGAATA
GCTACGCCATC -> CTACGCCATCC
GCTACTGCCTC -> CTACTGCCTCT
GCTAGAAGAGC -> CTAGAAGAGCG
GCTAGGAGAGA -> CTAGGAGAGAC
GCTAGGGTATC -> CTAGGGTATCA
GCTAGTACTAT -> CTAGTACTATG
GCTATAGCCAC -> CTATAGCCACG
GCTATGCGGAG -> CTATGCGGAGT
GCTATGGACAC -> CTATGGACACG
GCTCAATACAA -> CTCAATACAAG
GCTCAATCAAC -> CTCAATCAACC
GCTCAGAAACC -> CTCAGAAACCC
GCTCATGGCTT -> CTCATGGCTTG
GCTCGACTTTA -> CTCGACTTTAA
GCTGGAACCAA -> CTGGAACCAAT
GCTGGACAACG -> CTGGACAACGT
GCTGGGAGTTC -> CTGGGAGTTCT
GCTGTCCTCAT -> CTGTCCTCATC
GCTGTTTGTGA -> CTGTTTGTGAC
GCTTCACCTGC -> CTTCACCTGCT
GCTTCATCAGG -> CTTCATCAGGC
GCTTGAGGTAC -> CTTGAGGTACA
GCTTGCTTCAT -> CTTGCTTCATC
GCTTGGTTCGA -> CTTGGTTCGAA
GCTTGTTCCTA -> CTTGTTCCTAT
GCTTTAACAGT -> CTTTAACAGTA
GCTTTATGCAA -> CTTTATGCAAG
GCTTTCGCAGT -> CTTTCGCAGTA
GCTTTTCGCTA -> CTTTTCGCTAT
GGAAAACAGAT -> GAAAACAGATG
GGAAATGCCGG -> GAAATGCCGGC
GGAAATTTAGC -> GAAATTTAGCT
GGAACATAATC -> GAACATAATCC
GGAACCAATGC -> GAACCAATGCA
GGAACCACCAG -> GAACCACCAGC
GGAACCTTCAC -> GAACCTTCACC
GGAAGCAACCT -> GAAGCAACCTA
GGAAGGATTAT -> GAAGGATTATT
GGAAGTACGTG -> GAAGTACGTGG
GGAATCTACAC -> GAATCTACACC
GGAATGTGATA -> GAATGTGATAT
GGACAACGTGA -> GACAACGTGAG
GGACACGTGTG -> GACACGTGTGG
GGACCTCTGAC -> GACCTCTGACG
GGAGAGACATG -> GAGAGACATGG
GGAGAGCGTCC -> GAGAGCGTCCT
GGAGCCTCCGA -> GAGCCTCCGAA
GGAGCGACTGA -> GAGCGACTGAT
GGAGGCAGGAA -> GAGGCAGGAAC
GGAGTCTCTAC -> GAGTCTCTACT
GGAGTTCTTGG -> GAGTTCTTGGC
GGAGTTGGTAC -> GAGTTGGTACG
GGATAAACGAG -> GATAAACGAGG
GGATAATCATT -> GATAATCATTC
GGATCGAATCG -> GATCGAATCGT
GGATGCCCCCC -> GATGCCCCCCA
GGATTAATCCC -> GATTAATCCCG
GGATTATTCAT -> GATTATTCATG
GGATTCCTAAT -> GATTCCTAATC
GGATTTCTTTA -> GATTTCTTTAA
GGCAAGGAAAT -> GCAAGGAAATT
GGCACTAGCCC -> GCACTAGCCCG
GGCACTTGACT -> GCACTTGACTT
GGCAGGAACCA -> GCAGGAACCAC
GGCATGTTTTA -> GCATGTTTTAA
GGCATTATTAG -> GCATTATTAGC
GGCCACAAAGC -> GCCACAAAGCG
GGCCCCTAAGG -> GCCCCTAAGGT
GGCCCGAATAA -> GCCCGAATAAC
GGCCCTCGATA -> GCCCTCGATAT
GGCCGGCAAGG -> GCCGGCAAGGA
GGCCTCTTACT -> GCCTCTTACTA
GGCGCAACATA -> GCGCAACATAT
GGCGCAAGGGC -> GCGCAAGGGCA
GGCGCACCTCT -> GCGCACCTCTA
GGCGCAGATTC -> GCGCAGATTCC
GGCGCGTCAGG -> GCGCGTCAGGG
GGCTCATGGCT -> GCTCATGGCTT
GGCTTCACCTG -> GCTTCACCTGC
GGCTTGGTTCG -> GCTTGGTTCGA
GGGAGAGCGTC -> GGAGAGCGTCC
GGGAGTTCTTG -> GGAGTTCTTGG
GGGATCGAATC -> GGATCGAATCG
GGGCACTAGCC -> GGCACTAGCCC
GGGCACTTGAC -> GGCACTTGACT
GGGCCACAAAG -> GGCCACAAAGC
GGGCCCGAATA -> GGCCCGAATAA
GGGCCCTCGAT -> GGCCCTCGATA
GGGCGCAAGGG -> GGCGCAAGGGC
GGGCGCACCTC -> GGCGCACCTCT
GGGCGCGTCAG -> GGCGCGTCAGG
GGGGCCCTCGA -> GGGCCCTCGAT
GGGGTATTTGG -> GGGTATTTGGA
GGGTATCAGAG -> GGTATCAGAGA
GGGTATTTGGA -> GGTATTTGGAA
GGGTGAAGGTA -> GGTGAAGGTAC
GGGTGAGACCC -> GGTGAGACCCG
GGGTTAGTGCT -> GGTTAGTGCTA
GGTAAAGCTCA -> GTAAAGCTCAA
GGTAATCCGCT -> GTAATCCGCTT
GGTACACGTGC -> GTACACGTGCG
GGTACCTCCTC -> GTACCTCCTCC
GGTACGGAAGC -> GTACGGAAGCA
GGTACGGAAGT -> GTACGGAAGTA
GGTACGGGAGA -> GTACGGGAGAG
GGTAGTTCATG -> GTAGTTCATGA
GGTATATGTTC -> GTATATGTTCC
GGTATCAGAGA -> GTATCAGAGAA
GGTATTTGGAA -> GTATTTGGAAT
GGTCAAAAGCT -> GTCAAAAGCTT
GGTCGTAGCAA -> GTCGTAGCAAT
GGTCTACGAGG -> GTCTACGAGGT
GGTCTCGACTT -> GTCTCGACTTC
GGTGAACCGCG -> GTGAACCGCGT
GGTGAAGGTAC -> GTGAAGGTACC
GGTGAGACCCG -> GTGAGACCCGC
GGTGCCATCAG -> GTGCCATCAGA
GGTGTATGTGA -> GTGTATGTGAC
GGTTAGTGCTA -> GTTAGTGCTAG
GGTTCGAAGTG -> GTTCGAAGTGA
GGTTTCAGCTT -> GTTTCAGCTTG
GTAAAAGCCTA -> TAAAAGCCTAG
GTAAAGCTCAA -> TAAAGCTCAAT
GTAATCCGCTT -> TAATCCGCTTT
GTAATTACAGC -> TAATTACAGCA
GTAATTGTATC -> TAATTGTATCA
GTACACAAATG -> TACACAAATGA
GTACACGTGCG -> TACACGTGCGA
GTACAGCTAGG -> TACAGCTAGGA
GTACCTCCTCC -> TACCTCCTCCT
GTACCTGACAA -> TACCTGACAAA
GTACGCTATAG -> TACGCTATAGC
GTACGGAAGCA -> TACGGAAGCAA
GTACGGAAGTA -> TACGGAAGTAC
GTACGGGAGAG -> TACGGGAGAGC
GTACGTGGAAA -> TACGTGGAAAA
GTACTATGTCT -> TACTATGTCTG
GTACTGAATCA -> TACTGAATCAA
GTACTGGATGC -> TACTGGATGCC
GTAGCAATACG -> TAGCAATACGC
GTAGCCTCTGA -> TAGCCTCTGAT
GTAGGAGTTGG -> TAGGAGTTGGT
GTAGGCCCCTA -> TAGGCCCCTAA
GTAGGGATCGA -> TAGGGATCGAA
GTAGTGGACCT -> TAGTGGACCTC
GTAGTTCATGA -> TAGTTCATGAC
GTATAAACGCT -> TATAAACGCTT
GTATAAAGGAA -> TATAAAGGAAT
GTATATGTTCC -> TATATGTTCCA
GTATCAGAGAA -> TATCAGAGAAC
GTATCATGCAA -> TATCATGCAAC
GTATCTACCTC -> TATCTACCTCC
GTATGTGACCT -> TATGTGACCTT
GTATTTGGAAT -> TATTTGGAATC
GTATTTTCTCC -> TATTTTCTCCA
GTCAAAAGCTT -> TCAAAAGCTTT
GTCAGCTATGG -> TCAGCTATGGA
GTCAGGGCCAC -> TCAGGGCCACA
GTCAGGTGCCA -> TCAGGTGCCAT
GTCAGTAATTA -> TCAGTAATTAC
GTCCCCTCCGA -> TCCCCTCCGAA
GTCCCTGGATT -> TCCCTGGATTT
GTCCGGTAATC -> TCCGGTAATCC
GTCCTATCCGG -> TCCTATCCGGA
GTCCTCATCCA -> TCCTCATCCAA
GTCGCTTGAGG -> TCGCTTGAGGT
GTCGGTCTCGA -> TCGGTCTCGAC
GTCGTACTGAA -> TCGTACTGAAT
GTCGTAGCAAT -> TCGTAGCAATA
GTCGTGTACTG -> TCGTGTACTGG
GTCTACGAGGT -> TCTACGAGGTA
GTCTCGACTTC -> TCTCGACTTCC
GTCTCTACTCT -> TCTCTACTCTC
GTCTGGCTCAT -> TCTGGCTCATG
GTCTGGTCAAA -> TCTGGTCAAAA
GTCTTGATAAC -> TCTTGATAACT
GTCTTTTGTTT -> TCTTTTGTTTT
GTGAACCGCGT -> TGAACCGCGTC
GTGAAGGTACC -> TGAAGGTACCT
GTGACAAACCC -> TGACAAACCCG
GTGACACGTAG -> TGACACGTAGT
GTGACATGACA -> TGACATGACAA
GTGACCTTACG -> TGACCTTACGT
GTGACTAGCGC -> TGACTAGCGCG
GTGAGACCCGC -> TGAGACCCGCC
GTGAGGAACCT -> TGAGGAACCTT
GTGATATCCTA -> TGATATCCTAT
GTGCCATCAGA -> TGCCATCAGAA
GTGCGACAGAG -> TGCGACAGAGA
GTGCTAGGGTA -> TGCTAGGGTAT
GTGCTGGAACC -> TGCTGGAACCA
GTGGAAAACAG -> TGGAAAACAGA
GTGGACCTCTG -> TGGACCTCTGA
GTGGGCCCGAA -> TGGGCCCGAAT
GTGGGGTATTT -> TGGGGTATTTG
GTGGGTGAAGG -> TGGGTGAAGGT
GTGGTAAAGCT -> TGGTAAAGCTC
GTGGTAGTTCA -> TGGTAGTTCAT
GTGTACTGGAT -> TGTACTGGATG
GTGTATGTGAC -> TGTATGTGACC
GTGTGGGTGAA -> TGTGGGTGAAG
GTGTGGTAAAG -> TGTGGTAAAGC
GTTAGTAGGCC -> TTAGTAGGCCC
GTTAGTGCTAG -> TTAGTGCTAGG
GTTATCTCCCT -> TTATCTCCCTG
GTTCATGACAT -> TTCATGACATT
GTTCCACGGAG -> TTCCACGGAGG
GTTCCTATTTA -> TTCCTATTTAC
GTTCCTCACTA -> TTCCTCACTAG
GTTCGAAGATA -> TTCGAAGATAG
GTTCGAAGTGA -> TTCGAAGTGAC
GTTCGTCTGGT -> TTCGTCTGGTC
GTTCTTGGCCT -> TTCTTGGCCTC
GTTGGTACGGG -> TTGGTACGGGA
GTTTATGATTG -> TTTATGATTGA
GTTTCAGCTTG -> TTTCAGCTTGT
GTTTGCACAGA -> TTTGCACAGAT
GTTTGTGACAT -> TTTGTGACATG
GTTTTAATCCG -> TTTTAATCCGT
GTTTTCAGAAC -> TTTTCAGAACG
GTTTTGTTCGA -> TTTTGTTCGAA
GTTTTTTTAAT -> TTTTTTTAATG
TAAAACACATA -> AAAACACATAA
TAAAAGCCTAG -> AAAAGCCTAGC
TAAACGCTTTA -> AAACGCTTTAA
TAAAGCTCAAT -> AAAGCTCAATC
TAAAGGAATGT -> AAAGGAATGTG
TAAATGACTAT -> AAATGACTATC
TAAATGTAATT -> AAATGTAATTG
TAACAGTACAC -> AACAGTACACA
TAACCATAAGA -> AACCATAAGAG
TAACCTGGAAG -> AACCTGGAAGG
TAACGCGTAGG -> AACGCGTAGGA
TAACTGACCCA -> AACTGACCCAC
TAACTTTAGTA -> AACTTTAGTAT
TAAGAGCTACT -> AAGAGCTACTG
TAAGAGGGTGA -> AAGAGGGTGAG
TAAGCACGATG -> AAGCACGATGA
TAAGGTACGGA -> AAGGTACGGAA
TAAGTGCTGGA -> AAGTGCTGGAA
TAATCATTCCA -> AATCATTCCAG
TAATCCCGCTA -> AATCCCGCTAC
TAATCCCTCAG -> AATCCCTCAGC
TAATCCGCTTT -> AATCCGCTTTA
TAATCCGTGGG -> AATCCGTGGGC
TAATCGTCGCT -> AATCGTCGCTT
TAATGCCGAAA -> AATGCCGAAAC
TAATTACAGCA -> AATTACAGCAT
TAATTAGAAGA -> AATTAGAAGAT
TAATTGTATCA -> AATTGTATCAT
TACAAGAGTCT -> ACAAGAGTCTT
TACACAAATGA -> ACACAAATGAA
TACACCGATTG -> ACACCGATTGA
TACACGAATAC -> ACACGAATACT
TACACGTGCGA -> ACACGTGCGAC
TACAGCATATG -> ACAGCATATGC
TACAGCTAGGA -> ACAGCTAGGAG
TACCAATCGAA -> ACCAATCGAAC
TACCTACCTTG -> ACCTACCTTGG
TACCTCCGGGG -> ACCTCCGGGGC
TACCTCCTCCT -> ACCTCCTCCTC
TACCTCGCTGT -> ACCTCGCTGTC
TACCTGACAAA -> ACCTGACAAAT
TACCTTGGAGC -> ACCTTGGAGCC
TACGACTTCTC -> ACGACTTCTCC
TACGAGGTACG -> ACGAGGTACGG
TACGATATAGG -> ACGATATAGGA
TACGCAGTTTT -> ACGCAGTTTTG
TACGCCATCCA -> ACGCCATCCAC
TACGCGTGACA -> ACGCGTGACAA
TACGCTATAGC -> ACGCTATAGCC
TACGGAAGCAA -> ACGGAAGCAAC
TACGGAAGTAC -> ACGGAAGTACG
TACGGGAGAGC -> ACGGGAGAGCG
TACGTCGTGTA -> ACGTCGTGTAC
TACGTGGAAAA -> ACGTGGAAAAC
TACTAACCATA -> ACTAACCATAA
TACTATGTCTG -> ACTATGTCTGG
TACTCATGTCG -> ACTCATGTCGG
TACTCTCCTCA -> ACTCTCCTCAC
TACTCTCGCCC -> ACTCTCGCCCA
TACTGAATCAA -> ACTGAATCAAT
TACTGCCTCTT -> ACTGCCTCTTG
TACTGGATGCC -> ACTGGATGCCC
TACTGTCTTGA -> ACTGTCTTGAT
TACTTCTTTTG -> ACTTCTTTTGC
TAGAACGTAGC -> AGAACGTAGCC
TAGAAGAGCGG -> AGAAGAGCGGA
TAGAAGATGTT -> AGAAGATGTTC
TAGATAAATGA -> AGATAAATGAC
TAGCAATACGC -> AGCAATACGCG
TAGCCACGCTG -> AGCCACGCTGT
TAGCCCGCTAG -> AGCCCGCTAGT
TAGCCCGTCCC -> AGCCCGTCCCC
TAGCCCGTTTA -> AGCCCGTTTAT
TAGCCTCTGAT -> AGCCTCTGATG
TAGCGCGCTCA -> AGCGCGCTCAA
TAGCGCGGTGT -> AGCGCGGTGTA
TAGCTAGAAGA -> AGCTAGAAGAG
TAGGAAATGCC -> AGGAAATGCCG
TAGGAGAGACA -> AGGAGAGACAT
TAGGAGTTGGT -> AGGAGTTGGTA
TAGGCATGTTT -> AGGCATGTTTT
TAGGCCCCTAA -> AGGCCCCTAAG
TAGGGATCGAA -> AGGGATCGAAT
TAGGGTATCAG -> AGGGTATCAGA
TAGTACTATGT -> AGTACTATGTC
TAGTAGGCCCC -> AGTAGGCCCCT
TAGTATAAAGG -> AGTATAAAGGA
TAGTGCTAGGG -> AGTGCTAGGGT
TAGTGGACCTC -> AGTGGACCTCT
TAGTTCATGAC -> AGTTCATGACA
TATAAACGCTT -> ATAAACGCTTT
TATAAAGGAAT -> ATAAAGGAATG
TATAGCCACGC -> ATAGCCACGCT
TATAGGAAATG -> ATAGGAAATGC
TATATGTTCCA -> ATATGTTCCAC
TATCAGAGAAC -> ATCAGAGAACT
TATCATGCAAC -> ATCATGCAACG
TATCCGGATAA -> ATCCGGATAAT
TATCCGTGTGG -> ATCCGTGTGGT
TATCCTATGTA -> ATCCTATGTAT
TATCTACCTCC -> ATCTACCTCCG
TATCTCCCTGT -> ATCTCCCTGTC
TATGACTCACG -> ATGACTCACGT
TATGATTGATC -> ATGATTGATCA
TATGCAAGTAT -> ATGCAAGTATA
TATGCGGAGTC -> ATGCGGAGTCT
TATGCTTTCGC -> ATGCTTTCGCA
TATGGACACGT -> ATGGACACGTG
TATGGCATTAT -> ATGGCATTATT
TATGTATCTAC -> ATGTATCTACC
TATGTATTTTC -> ATGTATTTTCT
TATGTCTGGCT -> ATGTCTGGCTC
TATGTGACCTT -> ATGTGACCTTA
TATGTTCCACG -> ATGTTCCACGG
TATTAGCCCGT -> ATTAGCCCGTT
TATTCATGAGT -> ATTCATGAGTC
TATTGCAGGAT -> ATTGCAGGATA
TATTGTTAGTA -> ATTGTTAGTAG
TATTTACGATA -> ATTTACGATAT
TATTTGGAATC -> ATTTGGAATCT
TATTTTCTCCA -> ATTTTCTCCAC
TCAAAAGCTTT -> CAAAAGCTTTT
TCAACCCACGG -> CAACCCACGGA
TCAATACAAGA -> CAATACAAGAG
TCAATATGTAT -> CAATATGTATT
TCAATCAACCC -> CAATCAACCCA
TCAATGAAACT -> CAATGAAACTA
TCACAAAAGAC -> CACAAAAGACA
TCACCAACATC -> CACCAACATCT
TCACCACAGCC -> CACCACAGCCC
TCACCTGCTCA -> CACCTGCTCAG
TCACGTACCTG -> CACGTACCTGA
TCACTAGATAA -> CACTAGATAAA
TCAGAAACCCC -> CAGAAACCCCC
TCAGAAACCGG -> CAGAAACCGGT
TCAGAACGACT -> CAGAACGACTA
TCAGAGAACTG -> CAGAGAACTGA
TCAGCAAAGTT -> CAGCAAAGTTT
TCAGCTATGGA -> CAGCTATGGAC
TCAGCTTGTTC -> CAGCTTGTTCC
TCAGGCTTCAC -> CAGGCTTCACC
TCAGGGCCACA -> CAGGGCCACAA
TCAGGTGCCAT -> CAGGTGCCATC
TCAGTAATTAC -> CAGTAATTACA
TCATCAGGCTT -> CATCAGGCTTC
TCATCCAAAAT -> CATCCAAAATA
TCATGACATTG -> CATGACATTGG
TCATGAGTCAG -> CATGAGTCAGG
TCATGCAACGA -> CATGCAACGAC
TCATGGCTTGG -> CATGGCTTGGT
TCATGTCGGTC -> CATGTCGGTCT
TCATTCCAGAA -> CATTCCAGAAG
TCCAAAATAAG -> CCAAAATAAGA
TCCACGGAGGC -> CCACGGAGGCA
TCCACGGATTA -> CCACGGATTAA
TCCACTGCGTA -> CCACTGCGTAA
TCCAGAAGCGG -> CCAGAAGCGGG
TCCATCTTTAC -> CCATCTTTACT
TCCCAGCACAG -> CCCAGCACAGG
TCCCCTCCGAA -> CCCCTCCGAAT
TCCCGCTACAC -> CCCGCTACACG
TCCCTCAGCAA -> CCCTCAGCAAA
TCCCTGGATTT -> CCCTGGATTTC
TCCCTGTCCCT -> CCCTGTCCCTG
TCCGAAATCGA -> CCGAAATCGAC
TCCGAATAGGC -> CCGAATAGGCA
TCCGCTTTATG -> CCGCTTTATGC
TCCGGATAATC -> CCGGATAATCA
TCCGGCGCAGA -> CCGGCGCAGAT
TCCGGGGCCCT -> CCGGGGCCCTC
TCCGGTAATCC -> CCGGTAATCCG
TCCGTAGGGAT -> CCGTAGGGATC
TCCGTGGGCCC -> CCGTGGGCCCG
TCCGTGGTAGT -> CCGTGGTAGTT
TCCGTGTGGTA -> CCGTGTGGTAA
TCCGTTCGTCT -> CCGTTCGTCTG
TCCTAATCGTC -> CCTAATCGTCG
TCCTATCCGGA -> CCTATCCGGAT
TCCTATGTATC -> CCTATGTATCT
TCCTATTGTTA -> CCTATTGTTAG
TCCTATTTACG -> CCTATTTACGA
TCCTCACCAAC -> CCTCACCAACA
TCCTCACTAGA -> CCTCACTAGAT
TCCTCATCCAA -> CCTCATCCAAA
TCCTCCTCCTT -> CCTCCTCCTTG
TCCTCCTTGCT -> CCTCCTTGCTC
TCCTTGCTCGA -> CCTTGCTCGAC
TCGAACCCGCT -> CGAACCCGCTA
TCGAAGATAGC -> CGAAGATAGCC
TCGAAGTGACA -> CGAAGTGACAC
TCGAATCGTTA -> CGAATCGTTAT
TCGACGTGGGG -> CGACGTGGGGT
TCGACTTCCGT -> CGACTTCCGTA
TCGACTTTAAC -> CGACTTTAACG
TCGAGATACGC -> CGAGATACGCA
TCGATATTGCA -> CGATATTGCAG
TCGCAGTACAG -> CGCAGTACAGC
TCGCCCACATT -> CGCCCACATTC
TCGCTATGCGG -> CGCTATGCGGA
TCGCTGTCCTC -> CGCTGTCCTCA
TCGCTTGAGGT -> CGCTTGAGGTA
TCGGTCTCGAC -> CGGTCTCGACT
TCGTACTGAAT -> CGTACTGAATC
TCGTAGCAATA -> CGTAGCAATAC
TCGTCGCTTGA -> CGTCGCTTGAG
TCGTCTGGTCA -> CGTCTGGTCAA
TCGTGTACTGG -> CGTGTACTGGA
TCGTTATCTCC -> CGTTATCTCCC
TCTAATTAGAA -> CTAATTAGAAG
TCTACACCGAT -> CTACACCGATT
TCTACCTCCGG -> CTACCTCCGGG
TCTACGAGGTA -> CTACGAGGTAC
TCTACTCTCCT -> CTACTCTCCTC
TCTAGAACGTA -> CTAGAACGTAG
TCTCCACTGCG -> CTCCACTGCGT
TCTCCATCTTT -> CTCCATCTTTA
TCTCCCTGTCC -> CTCCCTGTCCC
TCTCCTCACCA -> CTCCTCACCAA
TCTCGACTTCC -> CTCGACTTCCG
TCTCGCCCACA -> CTCGCCCACAT
TCTCTACTCTC -> CTCTACTCTCC
TCTGACGTGAC -> CTGACGTGACT
TCTGATGACCC -> CTGATGACCCA
TCTGGCTCATG -> CTGGCTCATGG
TCTGGTCAAAA -> CTGGTCAAAAG
TCTTACTAACC -> CTTACTAACCA
TCTTCTTGCTT -> CTTCTTGCTTG
TCTTGATAACT -> CTTGATAACTT
TCTTGATCGAG -> CTTGATCGAGA
TCTTGCTTGCT -> CTTGCTTGCTT
TCTTGGCCTCT -> CTTGGCCTCTT
TCTTTAAAACA -> CTTTAAAACAC
TCTTTACTCTC -> CTTTACTCTCG
TCTTTCACAAA -> CTTTCACAAAA
TCTTTTGCACC -> CTTTTGCACCA
TCTTTTGTTTT -> CTTTTGTTTTC
TGAAAAGCTAC -> GAAAAGCTACG
TGAAACTACTG -> GAAACTACTGT
TGAACCGCGTC -> GAACCGCGTCG
TGAAGGTACCT -> GAAGGTACCTC
TGAATAAGCAC -> GAATAAGCACG
TGAATCAATGA -> GAATCAATGAA
TGACAAACCCG -> GACAAACCCGT
TGACAAAGCGA -> GACAAAGCGAC
TGACAAATAAA -> GACAAATAAAT
TGACACGTAGT -> GACACGTAGTG
TGACATGACAA -> GACATGACAAA
TGACATTGGGT -> GACATTGGGTT
TGACCCACTGC -> GACCCACTGCA
TGACCCATGGT -> GACCCATGGTT
TGACCTTACGT -> GACCTTACGTC
TGACGTGACTA -> GACGTGACTAG
TGACTAGCGCG -> GACTAGCGCGG
TGACTATCCGT -> GACTATCCGTG
TGACTCACGTA -> GACTCACGTAC
TGACTTTACCA -> GACTTTACCAA
TGAGACCCGCC -> GAGACCCGCCG
TGAGGAACCTT -> GAGGAACCTTC
TGAGGTACACG -> GAGGTACACGT
TGAGTACGCTA -> GAGTACGCTAT
TGAGTCAGGTG -> GAGTCAGGTGC
TGATAACTTTA -> GATAACTTTAG
TGATATCCTAT -> GATATCCTATG
TGATCAATATG -> GATCAATATGT
TGATCCTATTG -> GATCCTATTGT
TGATCGAGATA -> GATCGAGATAC
TGATGACCCAT -> GATGACCCATG
TGATGCTGGAC -> GATGCTGGACA
TGATTGATCAA -> GATTGATCAAT
TGCAACGACAC -> GCAACGACACC
TGCAAGTATAA -> GCAAGTATAAA
TGCACAGACTC -> GCACAGACTCC
TGCACAGATAC -> GCACAGATACC
TGCACCAGAGG -> GCACCAGAGGT
TGCAGGATAAA -> GCAGGATAAAC
TGCAGGTGAAC -> GCAGGTGAACC
TGCCATCAGAA -> GCCATCAGAAA
TGCCCCCCACC -> GCCCCCCACCT
TGCCGAAACTT -> GCCGAAACTTA
TGCCGGCCGGC -> GCCGGCCGGCA
TGCCTCTTGAT -> GCCTCTTGATC
TGCGACAGAGA -> GCGACAGAGAA
TGCGGAGTCTC -> GCGGAGTCTCT
TGCGTAAAAGC -> GCGTAAAAGCC
TGCTAGGGTAT -> GCTAGGGTATC
TGCTCAGAAAC -> GCTCAGAAACC
TGCTCGACTTT -> GCTCGACTTTA
TGCTGGAACCA -> GCTGGAACCAA
TGCTGGACAAC -> GCTGGACAACG
TGCTTCATCAG -> GCTTCATCAGG
TGCTTGCTTCA -> GCTTGCTTCAT
TGCTTTCGCAG -> GCTTTCGCAGT
TGGAAAACAGA -> GGAAAACAGAT
TGGAACATAAT -> GGAACATAATC
TGGAACCAATG -> GGAACCAATGC
TGGAAGGATTA -> GGAAGGATTAT
TGGAATCTACA -> GGAATCTACAC
TGGACAACGTG -> GGACAACGTGA
TGGACACGTGT -> GGACACGTGTG
TGGACCTCTGA -> GGACCTCTGAC
TGGAGCCTCCG -> GGAGCCTCCGA
TGGATGCCCCC -> GGATGCCCCCC
TGGATTTCTTT -> GGATTTCTTTA
TGGCATTATTA -> GGCATTATTAG
TGGCCTCTTAC -> GGCCTCTTACT
TGGCTCATGGC -> GGCTCATGGCT
TGGCTTGGTTC -> GGCTTGGTTCG
TGGGAGTTCTT -> GGGAGTTCTTG
TGGGCCCGAAT -> GGGCCCGAATA
TGGGCGCAAGG -> GGGCGCAAGGG
TGGGCGCACCT -> GGGCGCACCTC
TGGGGTATTTG -> GGGGTATTTGG
TGGGTGAAGGT -> GGGTGAAGGTA
TGGGTTAGTGC -> GGGTTAGTGCT
TGGTAAAGCTC -> GGTAAAGCTCA
TGGTACGGGAG -> GGTACGGGAGA
TGGTAGTTCAT -> GGTAGTTCATG
TGGTCAAAAGC -> GGTCAAAAGCT
TGGTCGTAGCA -> GGTCGTAGCAA
TGGTTCGAAGT -> GGTTCGAAGTG
TGGTTTCAGCT -> GGTTTCAGCTT
TGTAATTGTAT -> GTAATTGTATC
TGTACTGGATG -> GTACTGGATGC
TGTATCATGCA -> GTATCATGCAA
TGTATCTACCT -> GTATCTACCTC
TGTATGTGACC -> GTATGTGACCT
TGTATTTTCTC -> GTATTTTCTCC
TGTCCCTGGAT -> GTCCCTGGATT
TGTCCTCATCC -> GTCCTCATCCA
TGTCGGTCTCG -> GTCGGTCTCGA
TGTCTGGCTCA -> GTCTGGCTCAT
TGTCTTGATAA -> GTCTTGATAAC
TGTGACATGAC -> GTGACATGACA
TGTGACCTTAC -> GTGACCTTACG
TGTGATATCCT -> GTGATATCCTA
TGTGGGTGAAG -> GTGGGTGAAGG
TGTGGTAAAGC -> GTGGTAAAGCT
TGTTAGTAGGC -> GTTAGTAGGCC
TGTTCCACGGA -> GTTCCACGGAG
TGTTCCTATTT -> GTTCCTATTTA
TGTTCCTCACT -> GTTCCTCACTA
TGTTCGAAGAT -> GTTCGAAGATA
TGTTTGCACAG -> GTTTGCACAGA
TGTTTGTGACA -> GTTTGTGACAT
TGTTTTAATCC -> GTTTTAATCCG
TGTTTTCAGAA -> GTTTTCAGAAC
TTAAAACACAT -> TAAAACACATA
TTAACAGTACA -> TAACAGTACAC
TTAACGCGTAG -> TAACGCGTAGG
TTAATCCCGCT -> TAATCCCGCTA
TTAATCCGTGG -> TAATCCGTGGG
TTAATGCCGAA -> TAATGCCGAAA
TTACAGCATAT -> TACAGCATATG
TTACCAATCGA -> TACCAATCGAA
TTACGATATAG -> TACGATATAGG
TTACGTCGTGT -> TACGTCGTGTA
TTACTAACCAT -> TACTAACCATA
TTACTCTCGCC -> TACTCTCGCCC
TTAGAAGATGT -> TAGAAGATGTT
TTAGCCCGTTT -> TAGCCCGTTTA
TTAGCTAGAAG -> TAGCTAGAAGA
TTAGTAGGCCC -> TAGTAGGCCCC
TTAGTATAAAG -> TAGTATAAAGG
TTAGTGCTAGG -> TAGTGCTAGGG
TTATCTCCCTG -> TATCTCCCTGT
TTATGATTGAT -> TATGATTGATC
TTATGCAAGTA -> TATGCAAGTAT
TTATGGCATTA -> TATGGCATTAT
TTATTAGCCCG -> TATTAGCCCGT
TTATTCATGAG -> TATTCATGAGT
TTCACAAAAGA -> TCACAAAAGAC
TTCACCACAGC -> TCACCACAGCC
TTCACCTGCTC -> TCACCTGCTCA
TTCAGAACGAC -> TCAGAACGACT
TTCAGCTTGTT -> TCAGCTTGTTC
TTCATCAGGCT -> TCATCAGGCTT
TTCATGACATT -> TCATGACATTG
TTCATGAGTCA -> TCATGAGTCAG
TTCCACGGAGG -> TCCACGGAGGC
TTCCAGAAGCG -> TCCAGAAGCGG
TTCCCAGCACA -> TCCCAGCACAG
TTCCGTAGGGA -> TCCGTAGGGAT
TTCCGTGGTAG -> TCCGTGGTAGT
TTCCTAATCGT -> TCCTAATCGTC
TTCCTATTTAC -> TCCTATTTACG
TTCCTCACTAG -> TCCTCACTAGA
TTCGAAGATAG -> TCGAAGATAGC
TTCGAAGTGAC -> TCGAAGTGACA
TTCGCAGTACA -> TCGCAGTACAG
TTCGCTATGCG -> TCGCTATGCGG
TTCGTCTGGTC -> TCGTCTGGTCA
TTCTCCACTGC -> TCTCCACTGCG
TTCTCCATCTT -> TCTCCATCTTT
TTCTTGCTTGC -> TCTTGCTTGCT
TTCTTGGCCTC -> TCTTGGCCTCT
TTCTTTAAAAC -> TCTTTAAAACA
TTCTTTTGCAC -> TCTTTTGCACC
TTGAATAAGCA -> TGAATAAGCAC
TTGACTTTACC -> TGACTTTACCA
TTGAGGTACAC -> TGAGGTACACG
TTGATAACTTT -> TGATAACTTTA
TTGATCAATAT -> TGATCAATATG
TTGATCGAGAT -> TGATCGAGATA
TTGCACAGATA -> TGCACAGATAC
TTGCACCAGAG -> TGCACCAGAGG
TTGCAGGATAA -> TGCAGGATAAA
TTGCTCGACTT -> TGCTCGACTTT
TTGCTTCATCA -> TGCTTCATCAG
TTGCTTGCTTC -> TGCTTGCTTCA
TTGGAATCTAC -> TGGAATCTACA
TTGGAGCCTCC -> TGGAGCCTCCG
TTGGCCTCTTA -> TGGCCTCTTAC
TTGGGTTAGTG -> TGGGTTAGTGC
TTGGTACGGGA -> TGGTACGGGAG
TTGGTTCGAAG -> TGGTTCGAAGT
TTGTATCATGC -> TGTATCATGCA
TTGTGACATGA -> TGTGACATGAC
TTGTTAGTAGG -> TGTTAGTAGGC
TTGTTCCTATT -> TGTTCCTATTT
TTGTTCGAAGA -> TGTTCGAAGAT
TTGTTTTCAGA -> TGTTTTCAGAA
TTTAAAACACA -> TTAAAACACAT
TTTAACAGTAC -> TTAACAGTACA
TTTAACGCGTA -> TTAACGCGTAG
TTTAATCCGTG -> TTAATCCGTGG
TTTAATGCCGA -> TTAATGCCGAA
TTTACCAATCG -> TTACCAATCGA
TTTACGATATA -> TTACGATATAG
TTTACTCTCGC -> TTACTCTCGCC
TTTAGCTAGAA -> TTAGCTAGAAG
TTTAGTATAAA -> TTAGTATAAAG
TTTATGATTGA -> TTATGATTGAT
TTTATGCAAGT -> TTATGCAAGTA
TTTCACAAAAG -> TTCACAAAAGA
TTTCAGAACGA -> TTCAGAACGAC
TTTCAGCTTGT -> TTCAGCTTGTT
TTTCGCAGTAC -> TTCGCAGTACA
TTTCGCTATGC -> TTCGCTATGCG
TTTCTCCACTG -> TTCTCCACTGC
TTTCTTTAAAA -> TTCTTTAAAAC
TTTGCACAGAT -> TTGCACAGATA
TTTGCACCAGA -> TTGCACCAGAG
TTTGGAATCTA -> TTGGAATCTAC
TTTGTGACATG -> TTGTGACATGA
TTTGTTCGAAG -> TTGTTCGAAGA
TTTGTTTTCAG -> TTGTTTTCAGA
TTTTAATCCGT -> TTTAATCCGTG
TTTTAATGCCG -> TTTAATGCCGA
TTTTCAGAACG -> TTTCAGAACGA
TTTTCGCTATG -> TTTCGCTATGC
TTTTCTCCACT -> TTTCTCCACTG
TTTTGCACCAG -> TTTGCACCAGA
TTTTGTTCGAA -> TTTGTTCGAAG
TTTTGTTTTCA -> TTTGTTTTCAG
TTTTTAATGCC -> TTTTAATGCCG
TTTTTTAATGC -> TTTTTAATGCC
TTTTTTTAATG -> TTTTTTAATGC



======
Execution Time: 0.665999889374 s
Memory Used: 21 MB